,NumDealsPurchases,NumWebPurchases,NumCatalogPurchases,NumStorePurchases,NumPurchases,WebRatio
0,3,8,10,4,22,0.3636363636363636
1,2,1,1,2,4,0.25
2,1,8,2,10,20,0.4
3,2,2,0,4,6,0.3333333333333333
4,5,5,3,6,14,0.3571428571428571
5,2,6,4,10,20,0.3
6,4,7,3,7,17,0.4117647058823529
7,2,4,0,4,8,0.5
8,1,3,0,2,5,0.6
9,1,1,0,0,1,1.0
10,1,2,0,3,5,0.4
11,1,3,4,8,15,0.2
12,3,6,1,5,12,0.5
13,1,1,0,3,4,0.25
14,1,7,6,12,25,0.28
15,3,3,0,3,6,0.5
16,2,4,1,6,11,0.3636363636363636
17,2,11,4,9,24,0.4583333333333333
18,2,2,1,3,6,0.3333333333333333
19,1,4,2,5,11,0.3636363636363636
20,15,0,28,0,28,0.0
21,3,2,3,9,14,0.1428571428571428
22,3,6,2,9,17,0.3529411764705882
23,7,7,1,5,13,0.5384615384615384
24,2,2,1,3,6,0.3333333333333333
25,4,5,1,4,10,0.5
26,2,2,1,4,7,0.2857142857142857
27,1,6,9,10,25,0.24
28,2,3,0,3,6,0.5
29,1,2,5,3,10,0.2
30,2,2,1,4,7,0.2857142857142857
31,6,4,1,6,11,0.3636363636363636
32,1,3,5,9,17,0.1764705882352941
33,1,2,0,3,5,0.4
34,5,5,6,12,23,0.217391304347826
35,3,3,1,2,6,0.5
36,2,1,1,3,5,0.2
37,2,7,10,5,22,0.3181818181818182
38,2,8,6,5,19,0.4210526315789473
39,2,2,0,3,5,0.4
40,1,0,0,3,3,0.0
41,3,2,0,3,5,0.4
42,1,2,4,9,15,0.1333333333333333
43,3,3,1,3,7,0.4285714285714285
44,1,2,0,2,4,0.5
45,9,5,2,12,19,0.2631578947368421
46,1,4,2,10,16,0.25
47,1,6,9,13,28,0.2142857142857142
48,2,2,0,3,5,0.4
49,1,4,9,7,20,0.2
50,7,4,2,10,16,0.25
51,1,3,10,13,26,0.1153846153846153
52,1,5,5,10,20,0.25
53,1,1,0,4,5,0.2
54,3,8,2,6,16,0.5
55,1,3,6,11,20,0.15
56,4,4,2,12,18,0.2222222222222222
57,4,8,2,10,20,0.4
58,1,7,3,8,18,0.3888888888888889
59,1,7,4,4,15,0.4666666666666667
60,1,1,1,2,4,0.25
61,1,1,0,2,3,0.3333333333333333
62,1,11,10,10,31,0.3548387096774194
63,1,5,2,10,17,0.2941176470588235
64,7,2,5,5,12,0.1666666666666666
65,3,4,8,6,18,0.2222222222222222
66,4,10,3,13,26,0.3846153846153846
67,5,9,2,8,19,0.4736842105263157
68,1,2,1,4,7,0.2857142857142857
69,1,1,0,2,3,0.3333333333333333
70,1,7,6,5,18,0.3888888888888889
71,0,5,8,9,22,0.2272727272727272
72,1,0,0,3,3,0.0
73,2,10,1,8,19,0.5263157894736842
74,4,3,1,4,8,0.375
75,1,1,0,2,3,0.3333333333333333
76,3,3,0,3,6,0.5
77,1,2,5,3,10,0.2
78,1,3,10,13,26,0.1153846153846153
79,2,1,0,4,5,0.2
80,5,3,1,4,8,0.375
81,4,6,1,6,13,0.4615384615384615
82,1,5,6,7,18,0.2777777777777778
83,1,2,2,5,9,0.2222222222222222
84,1,1,0,3,4,0.25
85,3,3,1,3,7,0.4285714285714285
86,1,2,0,3,5,0.4
87,5,7,4,6,17,0.4117647058823529
88,2,2,0,3,5,0.4
89,1,5,7,12,24,0.2083333333333333
90,2,5,2,7,14,0.3571428571428571
91,2,2,0,3,5,0.4
92,2,2,0,3,5,0.4
93,2,9,5,11,25,0.36
94,1,6,3,6,15,0.4
95,1,3,11,5,19,0.1578947368421052
96,1,1,0,3,4,0.25
97,4,4,1,4,9,0.4444444444444444
98,4,6,4,12,22,0.2727272727272727
99,2,3,1,3,7,0.4285714285714285
100,1,5,4,4,13,0.3846153846153846
101,1,6,6,11,23,0.2608695652173913
102,1,7,4,5,16,0.4375
103,3,8,1,8,17,0.4705882352941176
104,1,6,7,11,24,0.25
105,5,6,4,6,16,0.375
106,2,2,1,3,6,0.3333333333333333
107,0,4,6,5,15,0.2666666666666666
108,5,9,1,5,15,0.6
109,2,1,1,3,5,0.2
110,2,2,0,3,5,0.4
111,4,6,2,10,18,0.3333333333333333
112,3,2,1,3,6,0.3333333333333333
113,2,1,0,3,4,0.25
114,1,1,0,3,4,0.25
115,0,6,8,13,27,0.2222222222222222
116,2,3,4,7,14,0.2142857142857142
117,1,3,6,6,15,0.2
118,2,2,0,4,6,0.3333333333333333
119,4,6,3,10,19,0.3157894736842105
120,5,5,4,5,14,0.3571428571428571
121,5,11,1,6,18,0.6111111111111112
122,1,7,2,9,18,0.3888888888888889
123,5,5,1,5,11,0.4545454545454545
124,1,4,5,13,22,0.1818181818181818
125,2,1,0,3,4,0.25
126,3,2,2,2,6,0.3333333333333333
127,2,1,1,2,4,0.25
128,2,2,0,3,5,0.4
129,1,5,4,12,21,0.238095238095238
130,2,3,5,7,15,0.2
131,1,5,7,10,22,0.2272727272727272
132,3,8,5,9,22,0.3636363636363636
133,3,4,2,3,9,0.4444444444444444
134,3,3,3,6,12,0.25
135,1,2,0,3,5,0.4
136,1,1,0,2,3,0.3333333333333333
137,7,4,1,4,9,0.4444444444444444
138,1,2,1,4,7,0.2857142857142857
139,1,4,4,7,15,0.2666666666666666
140,4,8,1,6,15,0.5333333333333333
141,4,7,1,5,13,0.5384615384615384
142,4,3,0,4,7,0.4285714285714285
143,2,8,5,11,24,0.3333333333333333
144,1,10,4,6,20,0.5
145,3,6,1,5,12,0.5
146,1,0,0,3,3,0.0
147,1,1,1,6,8,0.125
148,1,3,4,10,17,0.1764705882352941
149,1,1,0,2,3,0.3333333333333333
150,2,10,6,9,25,0.4
151,4,3,0,4,7,0.4285714285714285
152,1,5,4,10,19,0.2631578947368421
153,3,2,0,4,6,0.3333333333333333
154,1,6,7,4,17,0.3529411764705882
155,1,3,2,6,11,0.2727272727272727
156,1,3,4,7,14,0.2142857142857142
157,3,2,1,3,6,0.3333333333333333
158,2,1,0,3,4,0.25
159,2,2,0,3,5,0.4
160,1,3,1,3,7,0.4285714285714285
161,2,2,1,3,6,0.3333333333333333
162,1,2,2,2,6,0.3333333333333333
163,1,11,8,8,27,0.4074074074074074
164,1,9,10,5,24,0.375
165,2,2,0,3,5,0.4
166,1,0,0,3,3,0.0
167,1,5,7,12,24,0.2083333333333333
168,1,4,1,4,9,0.4444444444444444
169,3,2,1,3,6,0.3333333333333333
170,1,6,4,13,23,0.2608695652173913
171,1,1,1,3,5,0.2
172,1,2,0,3,5,0.4
173,1,1,1,2,4,0.25
174,2,1,0,4,5,0.2
175,2,7,1,8,16,0.4375
176,1,4,10,9,23,0.1739130434782608
177,2,2,0,3,5,0.4
178,1,1,1,2,4,0.25
179,1,8,7,12,27,0.2962962962962963
180,2,3,0,3,6,0.5
181,4,5,1,6,12,0.4166666666666667
182,2,1,1,2,4,0.25
183,1,7,3,12,22,0.3181818181818182
184,1,4,6,6,16,0.25
185,1,5,6,5,16,0.3125
186,6,5,1,3,9,0.5555555555555556
187,3,8,1,7,16,0.5
188,1,4,4,9,17,0.2352941176470588
189,3,11,6,9,26,0.4230769230769231
190,0,7,9,10,26,0.2692307692307692
191,2,1,0,3,4,0.25
192,1,0,1,2,3,0.0
193,1,1,0,3,4,0.25
194,6,4,2,5,11,0.3636363636363636
195,1,2,0,3,5,0.4
196,5,11,4,9,24,0.4583333333333333
197,5,3,1,6,10,0.3
198,1,4,6,9,19,0.2105263157894736
199,8,5,1,5,11,0.4545454545454545
200,10,7,1,8,16,0.4375
201,1,3,4,9,16,0.1875
202,6,8,1,5,14,0.5714285714285714
203,1,1,0,2,3,0.3333333333333333
204,1,8,10,6,24,0.3333333333333333
205,2,4,1,5,10,0.4
206,2,11,4,11,26,0.4230769230769231
207,1,1,1,4,6,0.1666666666666666
208,1,3,5,7,15,0.2
209,2,6,3,11,20,0.3
210,4,4,1,4,9,0.4444444444444444
211,5,9,6,12,27,0.3333333333333333
212,4,3,1,4,8,0.375
213,2,8,2,4,14,0.5714285714285714
214,3,2,2,11,15,0.1333333333333333
215,1,3,5,8,16,0.1875
216,1,1,0,2,3,0.3333333333333333
217,9,5,1,8,14,0.3571428571428571
218,1,6,3,4,13,0.4615384615384615
219,1,1,0,2,3,0.3333333333333333
220,1,1,0,3,4,0.25
221,3,7,8,11,26,0.2692307692307692
222,2,2,0,4,6,0.3333333333333333
223,1,1,0,3,4,0.25
224,1,5,2,11,18,0.2777777777777778
225,4,3,1,3,7,0.4285714285714285
226,1,6,5,10,21,0.2857142857142857
227,2,6,4,4,14,0.4285714285714285
228,1,2,0,2,4,0.5
229,1,3,9,9,21,0.1428571428571428
230,7,11,5,8,24,0.4583333333333333
231,2,1,0,3,4,0.25
232,2,5,3,6,14,0.3571428571428571
233,2,9,4,6,19,0.4736842105263157
234,1,4,10,5,19,0.2105263157894736
235,4,9,6,6,21,0.4285714285714285
236,2,2,0,3,5,0.4
237,2,1,0,3,4,0.25
238,1,6,9,13,28,0.2142857142857142
239,2,3,1,5,9,0.3333333333333333
240,5,4,6,11,21,0.1904761904761904
241,2,1,0,3,4,0.25
242,3,8,3,5,16,0.5
243,4,3,2,7,12,0.25
244,4,2,0,4,6,0.3333333333333333
245,1,1,0,2,3,0.3333333333333333
246,2,1,1,2,4,0.25
247,3,10,2,10,22,0.4545454545454545
248,4,4,1,6,11,0.3636363636363636
249,1,1,0,2,3,0.3333333333333333
250,6,5,2,4,11,0.4545454545454545
251,4,3,1,3,7,0.4285714285714285
252,1,3,7,8,18,0.1666666666666666
253,4,3,2,2,7,0.4285714285714285
254,1,3,3,6,12,0.25
255,2,2,2,2,6,0.3333333333333333
256,2,3,4,5,12,0.25
257,3,3,0,4,7,0.4285714285714285
258,2,4,2,4,10,0.4
259,4,2,0,4,6,0.3333333333333333
260,3,2,0,4,6,0.3333333333333333
261,2,6,3,12,21,0.2857142857142857
262,2,7,4,10,21,0.3333333333333333
263,1,3,3,5,11,0.2727272727272727
264,1,3,5,8,16,0.1875
265,1,9,3,9,21,0.4285714285714285
266,3,3,0,4,7,0.4285714285714285
267,2,8,2,4,14,0.5714285714285714
268,2,4,1,6,11,0.3636363636363636
269,1,5,1,8,14,0.3571428571428571
270,2,2,0,3,5,0.4
271,1,3,1,2,6,0.5
272,1,6,3,13,22,0.2727272727272727
273,13,6,2,12,20,0.3
274,1,5,11,5,21,0.238095238095238
275,3,7,1,5,13,0.5384615384615384
276,1,1,0,3,4,0.25
277,3,3,1,3,7,0.4285714285714285
278,1,2,7,9,18,0.1111111111111111
279,3,3,0,3,6,0.5
280,1,0,0,3,3,0.0
281,3,3,6,11,20,0.15
282,1,1,0,3,4,0.25
283,1,3,0,3,6,0.5
284,1,2,3,6,11,0.1818181818181818
285,5,8,3,12,23,0.3478260869565217
286,4,3,1,3,7,0.4285714285714285
287,1,9,2,9,20,0.45
288,1,2,1,3,6,0.3333333333333333
289,3,5,1,4,10,0.5
290,3,3,1,3,7,0.4285714285714285
291,1,6,7,9,22,0.2727272727272727
292,1,3,0,3,6,0.5
293,1,2,5,10,17,0.1176470588235294
294,1,8,3,6,17,0.4705882352941176
295,1,4,2,4,10,0.4
296,4,3,1,3,7,0.4285714285714285
297,2,2,0,3,5,0.4
298,1,6,6,10,22,0.2727272727272727
299,6,3,1,6,10,0.3
300,2,2,0,3,5,0.4
301,2,3,0,3,6,0.5
302,2,4,3,6,13,0.3076923076923077
303,2,1,0,3,4,0.25
304,3,3,3,12,18,0.1666666666666666
305,1,1,0,2,3,0.3333333333333333
306,1,1,0,2,3,0.3333333333333333
307,5,10,3,5,18,0.5555555555555556
308,6,8,2,8,18,0.4444444444444444
309,1,4,8,5,17,0.2352941176470588
310,3,2,0,4,6,0.3333333333333333
311,1,1,0,3,4,0.25
312,1,1,0,3,4,0.25
313,4,3,1,4,8,0.375
314,1,1,0,2,3,0.3333333333333333
315,1,1,1,3,5,0.2
316,2,9,3,5,17,0.5294117647058824
317,1,1,1,2,4,0.25
318,2,2,0,3,5,0.4
319,1,4,5,12,21,0.1904761904761904
320,1,11,4,6,21,0.5238095238095238
321,1,1,0,3,4,0.25
322,1,7,6,8,21,0.3333333333333333
323,1,4,5,11,20,0.2
324,1,2,1,4,7,0.2857142857142857
325,3,4,2,11,17,0.2352941176470588
326,2,3,5,8,16,0.1875
327,1,1,0,2,3,0.3333333333333333
328,1,2,9,4,15,0.1333333333333333
329,2,1,0,3,4,0.25
330,1,4,4,6,14,0.2857142857142857
331,3,2,0,3,5,0.4
332,1,1,0,2,3,0.3333333333333333
333,4,6,7,9,22,0.2727272727272727
334,2,8,4,8,20,0.4
335,3,4,6,5,15,0.2666666666666666
336,1,3,4,10,17,0.1764705882352941
337,5,11,3,5,19,0.5789473684210527
338,2,2,0,3,5,0.4
339,1,2,0,4,6,0.3333333333333333
340,1,3,3,8,14,0.2142857142857142
341,1,5,3,5,13,0.3846153846153846
342,2,4,6,4,14,0.2857142857142857
343,1,4,7,10,21,0.1904761904761904
344,3,6,2,10,18,0.3333333333333333
345,3,2,1,4,7,0.2857142857142857
346,1,1,0,2,3,0.3333333333333333
347,7,6,3,6,15,0.4
348,2,6,2,9,17,0.3529411764705882
349,1,4,10,11,25,0.16
350,2,2,0,3,5,0.4
351,1,4,3,8,15,0.2666666666666666
352,2,2,4,8,14,0.1428571428571428
353,1,1,0,3,4,0.25
354,6,5,1,4,10,0.5
355,1,1,1,2,4,0.25
356,4,4,3,12,19,0.2105263157894736
357,3,3,0,3,6,0.5
358,4,3,2,2,7,0.4285714285714285
359,1,1,1,2,4,0.25
360,1,1,0,3,4,0.25
361,2,3,5,10,18,0.1666666666666666
362,1,1,0,3,4,0.25
363,1,1,0,2,3,0.3333333333333333
364,1,0,0,3,3,0.0
365,3,4,1,6,11,0.3636363636363636
366,7,4,1,4,9,0.4444444444444444
367,1,0,1,2,3,0.0
368,3,1,2,2,5,0.2
369,3,7,3,4,14,0.5
370,4,4,5,13,22,0.1818181818181818
371,1,2,1,3,6,0.3333333333333333
372,3,2,2,12,16,0.125
373,0,5,6,8,19,0.2631578947368421
374,2,3,1,6,10,0.3
375,1,5,4,6,15,0.3333333333333333
376,1,4,1,4,9,0.4444444444444444
377,3,5,3,12,20,0.25
378,1,4,9,10,23,0.1739130434782608
379,4,3,1,4,8,0.375
380,2,1,1,2,4,0.25
381,1,1,0,3,4,0.25
382,4,2,2,3,7,0.2857142857142857
383,4,2,1,3,6,0.3333333333333333
384,1,9,4,9,22,0.4090909090909091
385,5,2,1,5,8,0.25
386,1,5,1,4,10,0.5
387,9,6,3,6,15,0.4
388,1,1,0,3,4,0.25
389,3,2,0,4,6,0.3333333333333333
390,3,5,1,5,11,0.4545454545454545
391,1,3,0,2,5,0.6
392,3,7,1,8,16,0.4375
393,2,3,0,3,6,0.5
394,4,4,3,6,13,0.3076923076923077
395,3,11,9,12,32,0.34375
396,3,5,1,7,13,0.3846153846153846
397,2,5,4,8,17,0.2941176470588235
398,1,3,5,10,18,0.1666666666666666
399,3,2,1,3,6,0.3333333333333333
400,1,2,7,11,20,0.1
401,1,7,9,9,25,0.28
402,9,10,2,8,20,0.5
403,2,2,0,3,5,0.4
404,1,2,0,3,5,0.4
405,1,1,0,2,3,0.3333333333333333
406,1,3,4,8,15,0.2
407,0,7,10,5,22,0.3181818181818182
408,1,1,0,2,3,0.3333333333333333
409,1,6,7,13,26,0.2307692307692307
410,2,2,5,10,17,0.1176470588235294
411,2,1,0,4,5,0.2
412,2,5,5,12,22,0.2272727272727272
413,1,2,4,9,15,0.1333333333333333
414,5,8,1,7,16,0.5
415,15,9,6,9,24,0.375
416,1,8,3,13,24,0.3333333333333333
417,2,1,0,4,5,0.2
418,1,1,0,3,4,0.25
419,3,6,2,12,20,0.3
420,2,9,1,5,15,0.6
421,3,2,1,4,7,0.2857142857142857
422,2,2,0,3,5,0.4
423,1,1,0,3,4,0.25
424,2,2,1,5,8,0.25
425,1,0,0,3,3,0.0
426,1,1,0,3,4,0.25
427,1,1,0,3,4,0.25
428,1,1,0,2,3,0.3333333333333333
429,2,5,0,4,9,0.5555555555555556
430,1,4,5,7,16,0.25
431,2,2,0,3,5,0.4
432,2,3,2,9,14,0.2142857142857142
433,5,4,7,11,22,0.1818181818181818
434,3,8,9,7,24,0.3333333333333333
435,1,2,0,4,6,0.3333333333333333
436,2,4,2,8,14,0.2857142857142857
437,3,9,5,10,24,0.375
438,7,5,1,6,12,0.4166666666666667
439,1,7,7,9,23,0.3043478260869565
440,4,4,1,5,10,0.4
441,2,2,1,8,11,0.1818181818181818
442,1,5,7,6,18,0.2777777777777778
443,4,2,2,8,12,0.1666666666666666
444,1,3,7,11,21,0.1428571428571428
445,2,3,1,3,7,0.4285714285714285
446,1,3,7,8,18,0.1666666666666666
447,2,4,0,3,7,0.5714285714285714
448,1,2,8,9,19,0.1052631578947368
449,1,5,6,5,16,0.3125
450,1,1,0,2,3,0.3333333333333333
451,3,7,2,8,17,0.4117647058823529
452,3,7,3,12,22,0.3181818181818182
453,4,6,10,13,29,0.2068965517241379
454,1,1,0,2,3,0.3333333333333333
455,7,8,6,9,23,0.3478260869565217
456,2,1,0,3,4,0.25
457,1,1,1,2,4,0.25
458,4,8,3,11,22,0.3636363636363636
459,2,1,0,3,4,0.25
460,1,7,1,8,16,0.4375
461,4,6,2,7,15,0.4
462,7,7,3,4,14,0.5
463,1,2,1,2,5,0.4
464,1,2,0,3,5,0.4
465,2,6,2,2,10,0.6
466,4,4,2,5,11,0.3636363636363636
467,1,5,9,4,18,0.2777777777777778
468,1,5,10,13,28,0.1785714285714285
469,2,3,5,7,15,0.2
470,2,7,2,10,19,0.3684210526315789
471,1,1,0,3,4,0.25
472,1,4,1,4,9,0.4444444444444444
473,2,2,5,12,19,0.1052631578947368
474,2,6,1,5,12,0.5
475,1,3,5,13,21,0.1428571428571428
476,4,2,6,3,11,0.1818181818181818
477,1,9,4,6,19,0.4736842105263157
478,3,5,3,11,19,0.2631578947368421
479,1,2,0,3,5,0.4
480,1,4,9,4,17,0.2352941176470588
481,3,6,7,11,24,0.25
482,1,4,3,13,20,0.2
483,2,1,1,2,4,0.25
484,1,1,0,3,4,0.25
485,1,4,1,3,8,0.5
486,2,4,3,12,19,0.2105263157894736
487,1,1,0,3,4,0.25
488,2,10,4,12,26,0.3846153846153846
489,1,5,10,8,23,0.217391304347826
490,1,3,7,11,21,0.1428571428571428
491,1,2,1,4,7,0.2857142857142857
492,6,5,2,12,19,0.2631578947368421
493,3,4,2,3,9,0.4444444444444444
494,1,6,4,12,22,0.2727272727272727
495,3,6,2,5,13,0.4615384615384615
496,1,5,6,7,18,0.2777777777777778
497,4,6,2,5,13,0.4615384615384615
498,1,5,7,9,21,0.238095238095238
499,4,3,1,3,7,0.4285714285714285
500,1,1,0,3,4,0.25
501,1,4,5,7,16,0.25
502,1,6,3,10,19,0.3157894736842105
503,2,2,0,3,5,0.4
504,1,2,4,6,12,0.1666666666666666
505,1,5,1,6,12,0.4166666666666667
506,1,2,4,9,15,0.1333333333333333
507,3,2,2,3,7,0.2857142857142857
508,1,1,0,3,4,0.25
509,1,4,5,10,19,0.2105263157894736
510,1,4,4,6,14,0.2857142857142857
511,1,4,8,4,16,0.25
512,6,4,1,8,13,0.3076923076923077
513,4,4,3,8,15,0.2666666666666666
514,1,4,7,5,16,0.25
515,7,8,2,6,16,0.5
516,2,3,2,5,10,0.3
517,2,2,0,3,5,0.4
518,4,6,1,5,12,0.5
519,1,2,1,3,6,0.3333333333333333
520,1,8,3,4,15,0.5333333333333333
521,2,2,1,7,10,0.2
522,3,3,0,3,6,0.5
523,3,3,0,3,6,0.5
524,2,4,1,4,9,0.4444444444444444
525,2,4,5,3,12,0.3333333333333333
526,1,7,6,6,19,0.3684210526315789
527,2,4,6,8,18,0.2222222222222222
528,2,2,0,4,6,0.3333333333333333
529,1,3,6,4,13,0.2307692307692307
530,1,3,0,4,7,0.4285714285714285
531,4,3,1,2,6,0.5
532,2,1,0,3,4,0.25
533,2,1,1,3,5,0.2
534,2,3,1,2,6,0.5
535,2,6,2,8,16,0.375
536,1,3,2,2,7,0.4285714285714285
537,1,3,8,13,24,0.125
538,6,4,1,5,10,0.4
539,2,6,2,11,19,0.3157894736842105
540,1,5,6,7,18,0.2777777777777778
541,2,2,0,4,6,0.3333333333333333
542,1,5,10,4,19,0.2631578947368421
543,1,2,0,4,6,0.3333333333333333
544,0,6,6,7,19,0.3157894736842105
545,2,8,3,13,24,0.3333333333333333
546,5,6,3,12,21,0.2857142857142857
547,3,3,2,7,12,0.25
548,2,3,2,5,10,0.3
549,4,4,2,9,15,0.2666666666666666
550,1,1,0,2,3,0.3333333333333333
551,1,1,0,2,3,0.3333333333333333
552,1,1,0,2,3,0.3333333333333333
553,5,5,1,5,11,0.4545454545454545
554,2,1,0,3,4,0.25
555,3,4,1,3,8,0.5
556,1,5,1,5,11,0.4545454545454545
557,2,2,0,3,5,0.4
558,3,6,4,8,18,0.3333333333333333
559,3,4,1,3,8,0.5
560,4,3,0,3,6,0.5
561,2,2,0,4,6,0.3333333333333333
562,6,4,2,4,10,0.4
563,5,3,1,6,10,0.3
564,7,7,1,5,13,0.5384615384615384
565,1,1,0,3,4,0.25
566,1,2,1,3,6,0.3333333333333333
567,2,2,0,3,5,0.4
568,4,2,1,4,7,0.2857142857142857
569,1,5,11,5,21,0.238095238095238
570,2,4,4,10,18,0.2222222222222222
571,3,7,1,7,15,0.4666666666666667
572,1,1,1,3,5,0.2
573,2,2,1,2,5,0.4
574,0,5,11,5,21,0.238095238095238
575,1,3,7,9,19,0.1578947368421052
576,1,1,0,3,4,0.25
577,1,3,4,7,14,0.2142857142857142
578,3,3,1,2,6,0.5
579,1,2,0,3,5,0.4
580,2,1,0,3,4,0.25
581,3,2,1,3,6,0.3333333333333333
582,3,3,0,4,7,0.4285714285714285
583,1,1,0,3,4,0.25
584,3,5,3,12,20,0.25
585,1,3,4,9,16,0.1875
586,3,5,2,10,17,0.2941176470588235
587,4,3,1,3,7,0.4285714285714285
588,4,5,1,2,8,0.625
589,2,1,1,3,5,0.2
590,1,1,0,3,4,0.25
591,2,1,0,3,4,0.25
592,1,6,4,7,17,0.3529411764705882
593,2,3,1,6,10,0.3
594,1,3,1,7,11,0.2727272727272727
595,1,1,0,3,4,0.25
596,2,2,0,3,5,0.4
597,3,6,3,13,22,0.2727272727272727
598,5,6,2,5,13,0.4615384615384615
599,2,1,0,3,4,0.25
600,0,0,0,1,1,0.0
601,1,1,0,3,4,0.25
602,5,1,2,9,12,0.0833333333333333
603,3,6,1,7,14,0.4285714285714285
604,1,2,1,2,5,0.4
605,1,4,3,6,13,0.3076923076923077
606,1,1,0,3,4,0.25
607,1,6,8,6,20,0.3
608,2,2,0,3,5,0.4
609,1,8,4,7,19,0.4210526315789473
610,7,11,11,5,27,0.4074074074074074
611,3,3,0,3,6,0.5
612,3,4,1,4,9,0.4444444444444444
613,2,7,3,13,23,0.3043478260869565
614,1,3,4,6,13,0.2307692307692307
615,5,6,3,12,21,0.2857142857142857
616,1,2,1,3,6,0.3333333333333333
617,1,6,7,7,20,0.3
618,1,1,0,2,3,0.3333333333333333
619,1,9,11,11,31,0.2903225806451613
620,1,4,2,7,13,0.3076923076923077
621,5,8,4,9,21,0.3809523809523809
622,2,6,2,8,16,0.375
623,4,4,5,13,22,0.1818181818181818
624,1,5,9,6,20,0.25
625,4,9,4,6,19,0.4736842105263157
626,2,5,4,4,13,0.3846153846153846
627,1,4,2,6,12,0.3333333333333333
628,7,3,1,6,10,0.3
629,0,9,8,13,30,0.3
630,1,3,1,6,10,0.3
631,3,7,6,12,25,0.28
632,2,7,1,7,15,0.4666666666666667
633,0,4,6,9,19,0.2105263157894736
634,2,1,0,3,4,0.25
635,5,9,6,12,27,0.3333333333333333
636,1,1,1,4,6,0.1666666666666666
637,2,7,1,5,13,0.5384615384615384
638,2,3,1,4,8,0.375
639,2,3,1,5,9,0.3333333333333333
640,1,9,3,13,25,0.36
641,4,3,2,3,8,0.375
642,4,7,2,9,18,0.3888888888888889
643,1,0,0,3,3,0.0
644,1,6,4,13,23,0.2608695652173913
645,1,2,0,3,5,0.4
646,1,1,0,3,4,0.25
647,1,1,1,2,4,0.25
648,1,1,0,2,3,0.3333333333333333
649,2,2,0,3,5,0.4
650,1,1,0,3,4,0.25
651,3,3,1,5,9,0.3333333333333333
652,3,7,8,10,25,0.28
653,5,5,2,9,16,0.3125
654,4,4,3,6,13,0.3076923076923077
655,2,6,4,8,18,0.3333333333333333
656,2,2,4,8,14,0.1428571428571428
657,1,1,0,2,3,0.3333333333333333
658,3,10,3,5,18,0.5555555555555556
659,1,2,2,12,16,0.125
660,4,4,1,3,8,0.5
661,1,3,3,13,19,0.1578947368421052
662,2,8,9,4,21,0.3809523809523809
663,1,11,5,13,29,0.3793103448275862
664,1,8,1,5,14,0.5714285714285714
665,2,3,1,6,10,0.3
666,1,2,8,6,16,0.125
667,2,5,2,11,18,0.2777777777777778
668,1,5,6,10,21,0.238095238095238
669,1,3,5,12,20,0.15
670,1,4,6,4,14,0.2857142857142857
671,6,4,5,7,16,0.25
672,1,5,3,4,12,0.4166666666666667
673,3,1,4,4,9,0.1111111111111111
674,1,1,0,3,4,0.25
675,3,2,2,2,6,0.3333333333333333
676,1,2,1,4,7,0.2857142857142857
677,1,1,0,2,3,0.3333333333333333
678,3,2,0,3,5,0.4
679,2,8,4,6,18,0.4444444444444444
680,1,10,7,10,27,0.3703703703703703
681,3,9,3,5,17,0.5294117647058824
682,2,8,2,8,18,0.4444444444444444
683,3,5,2,11,18,0.2777777777777778
684,1,3,4,7,14,0.2142857142857142
685,3,4,1,4,9,0.4444444444444444
686,2,8,4,8,20,0.4
687,1,1,1,3,5,0.2
688,2,9,3,6,18,0.5
689,3,2,4,5,11,0.1818181818181818
690,1,1,1,2,4,0.25
691,1,1,0,2,3,0.3333333333333333
692,4,7,5,10,22,0.3181818181818182
693,2,2,1,3,6,0.3333333333333333
694,3,5,4,8,17,0.2941176470588235
695,3,4,1,5,10,0.4
696,1,3,2,5,10,0.3
697,1,5,3,8,16,0.3125
698,2,2,0,3,5,0.4
699,6,11,5,9,25,0.44
700,1,1,0,2,3,0.3333333333333333
701,2,5,4,5,14,0.3571428571428571
702,1,11,1,8,20,0.55
703,2,1,0,3,4,0.25
704,1,5,6,4,15,0.3333333333333333
705,5,4,1,2,7,0.5714285714285714
706,1,2,0,3,5,0.4
707,1,6,5,12,23,0.2608695652173913
708,1,3,8,11,22,0.1363636363636363
709,7,6,3,5,14,0.4285714285714285
710,1,11,6,8,25,0.44
711,1,0,0,3,3,0.0
712,8,7,2,6,15,0.4666666666666667
713,7,4,2,10,16,0.25
714,5,6,1,4,11,0.5454545454545454
715,3,4,3,4,11,0.3636363636363636
716,1,4,8,13,25,0.16
717,2,8,5,4,17,0.4705882352941176
718,1,4,1,7,12,0.3333333333333333
719,1,1,0,2,3,0.3333333333333333
720,2,7,5,6,18,0.3888888888888889
721,4,6,9,11,26,0.2307692307692307
722,2,3,0,3,6,0.5
723,3,2,1,3,6,0.3333333333333333
724,2,3,0,4,7,0.4285714285714285
725,1,6,9,5,20,0.3
726,1,4,4,11,19,0.2105263157894736
727,3,2,0,4,6,0.3333333333333333
728,1,3,8,12,23,0.1304347826086956
729,1,1,0,2,3,0.3333333333333333
730,1,10,10,7,27,0.3703703703703703
731,1,6,10,5,21,0.2857142857142857
732,2,3,2,10,15,0.2
733,1,6,4,13,23,0.2608695652173913
734,1,8,5,11,24,0.3333333333333333
735,1,8,6,6,20,0.4
736,1,7,3,13,23,0.3043478260869565
737,5,7,6,5,18,0.3888888888888889
738,5,3,4,8,15,0.2
739,2,2,1,3,6,0.3333333333333333
740,1,3,2,2,7,0.4285714285714285
741,2,3,0,3,6,0.5
742,2,8,1,8,17,0.4705882352941176
743,1,6,4,10,20,0.3
744,1,2,1,2,5,0.4
745,1,2,11,5,18,0.1111111111111111
746,3,3,2,4,9,0.3333333333333333
747,1,3,6,7,16,0.1875
748,1,11,5,12,28,0.3928571428571428
749,1,2,1,4,7,0.2857142857142857
750,4,6,1,7,14,0.4285714285714285
751,2,5,2,12,19,0.2631578947368421
752,1,8,5,6,19,0.4210526315789473
753,8,7,3,7,17,0.4117647058823529
754,3,2,0,4,6,0.3333333333333333
755,0,0,0,1,1,0.0
756,1,1,0,2,3,0.3333333333333333
757,2,2,1,3,6,0.3333333333333333
758,1,2,11,4,17,0.1176470588235294
759,2,1,0,3,4,0.25
760,2,6,9,5,20,0.3
761,1,4,4,10,18,0.2222222222222222
762,2,1,0,3,4,0.25
763,1,1,1,2,4,0.25
764,1,1,0,2,3,0.3333333333333333
765,1,1,0,3,4,0.25
766,2,2,0,3,5,0.4
767,5,3,0,4,7,0.4285714285714285
768,6,6,8,4,18,0.3333333333333333
769,6,7,1,8,16,0.4375
770,4,7,1,5,13,0.5384615384615384
771,1,3,6,4,13,0.2307692307692307
772,1,5,4,7,16,0.3125
773,1,2,0,3,5,0.4
774,4,3,3,5,11,0.2727272727272727
775,2,1,1,5,7,0.1428571428571428
776,1,4,1,7,12,0.3333333333333333
777,3,10,3,7,20,0.5
778,3,11,4,8,23,0.4782608695652174
779,1,6,5,12,23,0.2608695652173913
780,3,4,0,3,7,0.5714285714285714
781,4,4,4,9,17,0.2352941176470588
782,1,1,0,3,4,0.25
783,3,2,1,4,7,0.2857142857142857
784,1,6,8,13,27,0.2222222222222222
785,3,2,8,12,22,0.0909090909090909
786,6,7,1,7,15,0.4666666666666667
787,1,1,1,3,5,0.2
788,4,3,4,6,13,0.2307692307692307
789,7,3,2,8,13,0.2307692307692307
790,2,5,9,6,20,0.25
791,1,1,1,2,4,0.25
792,2,2,0,3,5,0.4
793,1,5,4,6,15,0.3333333333333333
794,6,5,7,9,21,0.238095238095238
795,0,5,5,12,22,0.2272727272727272
796,2,5,4,7,16,0.3125
797,1,1,0,2,3,0.3333333333333333
798,3,10,2,4,16,0.625
799,1,9,2,9,20,0.45
800,2,2,0,3,5,0.4
801,1,5,4,8,17,0.2941176470588235
802,2,2,0,3,5,0.4
803,1,7,3,7,17,0.4117647058823529
804,1,3,2,2,7,0.4285714285714285
805,1,5,10,4,19,0.2631578947368421
806,1,10,2,11,23,0.4347826086956521
807,3,3,4,7,14,0.2142857142857142
808,2,1,0,3,4,0.25
809,1,8,9,4,21,0.3809523809523809
810,1,1,0,3,4,0.25
811,1,2,0,3,5,0.4
812,1,6,4,7,17,0.3529411764705882
813,3,7,3,7,17,0.4117647058823529
814,2,2,0,3,5,0.4
815,2,1,0,3,4,0.25
816,5,6,5,12,23,0.2608695652173913
817,2,6,1,5,12,0.5
818,1,7,7,12,26,0.2692307692307692
819,1,1,0,3,4,0.25
820,2,7,6,5,18,0.3888888888888889
821,3,2,1,3,6,0.3333333333333333
822,3,3,2,6,11,0.2727272727272727
823,4,3,0,4,7,0.4285714285714285
824,4,4,0,3,7,0.5714285714285714
825,1,3,6,7,16,0.1875
826,1,5,6,7,18,0.2777777777777778
827,2,3,6,8,17,0.1764705882352941
828,3,7,5,8,20,0.35
829,2,3,1,5,9,0.3333333333333333
830,4,3,1,3,7,0.4285714285714285
831,2,5,3,3,11,0.4545454545454545
832,3,6,2,9,17,0.3529411764705882
833,1,7,7,10,24,0.2916666666666667
834,2,1,1,2,4,0.25
835,3,7,1,7,15,0.4666666666666667
836,7,10,2,12,24,0.4166666666666667
837,1,1,0,3,4,0.25
838,3,6,2,11,19,0.3157894736842105
839,2,1,0,3,4,0.25
840,1,6,9,10,25,0.24
841,2,2,0,3,5,0.4
842,6,6,1,4,11,0.5454545454545454
843,1,0,0,3,3,0.0
844,6,4,1,6,11,0.3636363636363636
845,2,6,1,4,11,0.5454545454545454
846,3,4,2,8,14,0.2857142857142857
847,3,5,1,8,14,0.3571428571428571
848,1,1,0,2,3,0.3333333333333333
849,3,2,3,8,13,0.1538461538461538
850,2,2,0,3,5,0.4
851,1,5,7,4,16,0.3125
852,2,5,5,4,14,0.3571428571428571
853,3,4,0,3,7,0.5714285714285714
854,4,3,1,4,8,0.375
855,1,5,7,10,22,0.2272727272727272
856,1,4,8,5,17,0.2352941176470588
857,7,6,6,4,16,0.375
858,2,3,0,4,7,0.4285714285714285
859,1,6,9,12,27,0.2222222222222222
860,4,3,1,3,7,0.4285714285714285
861,3,3,1,2,6,0.5
862,2,2,0,3,5,0.4
863,1,0,0,3,3,0.0
864,2,2,0,3,5,0.4
865,1,5,6,10,21,0.238095238095238
866,1,3,2,13,18,0.1666666666666666
867,4,6,1,4,11,0.5454545454545454
868,2,2,0,3,5,0.4
869,8,9,2,5,16,0.5625
870,2,2,6,10,18,0.1111111111111111
871,2,2,0,3,5,0.4
872,6,5,2,5,12,0.4166666666666667
873,1,3,10,11,24,0.125
874,1,1,0,2,3,0.3333333333333333
875,2,7,10,5,22,0.3181818181818182
876,2,8,10,5,23,0.3478260869565217
877,1,6,9,4,19,0.3157894736842105
878,2,10,6,7,23,0.4347826086956521
879,3,4,2,8,14,0.2857142857142857
880,4,4,0,3,7,0.5714285714285714
881,1,4,3,10,17,0.2352941176470588
882,2,4,1,4,9,0.4444444444444444
883,1,4,5,6,15,0.2666666666666666
884,1,3,3,6,12,0.25
885,5,4,1,6,11,0.3636363636363636
886,0,7,4,7,18,0.3888888888888889
887,1,1,0,2,3,0.3333333333333333
888,1,2,0,3,5,0.4
889,1,2,1,6,9,0.2222222222222222
890,1,3,10,8,21,0.1428571428571428
891,1,3,10,5,18,0.1666666666666666
892,6,10,5,10,25,0.4
893,2,3,1,4,8,0.375
894,1,7,3,7,17,0.4117647058823529
895,1,3,4,6,13,0.2307692307692307
896,1,3,4,7,14,0.2142857142857142
897,1,7,6,6,19,0.3684210526315789
898,2,3,2,7,12,0.25
899,1,6,9,9,24,0.25
900,1,1,0,3,4,0.25
901,1,2,10,6,18,0.1111111111111111
902,1,2,0,4,6,0.3333333333333333
903,3,1,1,4,6,0.1666666666666666
904,1,11,4,10,25,0.44
905,3,6,1,6,13,0.4615384615384615
906,1,4,5,9,18,0.2222222222222222
907,1,4,4,10,18,0.2222222222222222
908,1,5,4,6,15,0.3333333333333333
909,1,6,9,5,20,0.3
910,1,6,4,9,19,0.3157894736842105
911,1,1,1,4,6,0.1666666666666666
912,2,11,2,10,23,0.4782608695652174
913,1,1,0,3,4,0.25
914,1,2,11,5,18,0.1111111111111111
915,2,3,0,3,6,0.5
916,1,9,3,4,16,0.5625
917,3,11,5,11,27,0.4074074074074074
918,3,7,5,11,23,0.3043478260869565
919,2,8,4,9,21,0.3809523809523809
920,8,6,3,5,14,0.4285714285714285
921,2,7,4,7,18,0.3888888888888889
922,1,3,2,6,11,0.2727272727272727
923,0,5,8,5,18,0.2777777777777778
924,3,2,1,3,6,0.3333333333333333
925,1,4,4,10,18,0.2222222222222222
926,3,4,4,9,17,0.2352941176470588
927,2,4,2,5,11,0.3636363636363636
928,1,2,0,3,5,0.4
929,2,3,2,9,14,0.2142857142857142
930,1,2,0,3,5,0.4
931,3,2,1,3,6,0.3333333333333333
932,4,3,1,4,8,0.375
933,1,3,1,2,6,0.5
934,1,1,1,2,4,0.25
935,5,3,0,4,7,0.4285714285714285
936,3,5,2,6,13,0.3846153846153846
937,4,5,5,8,18,0.2777777777777778
938,2,2,0,4,6,0.3333333333333333
939,4,5,2,5,12,0.4166666666666667
940,2,4,7,13,24,0.1666666666666666
941,3,6,3,8,17,0.3529411764705882
942,2,2,0,3,5,0.4
943,5,2,1,5,8,0.25
944,7,3,1,6,10,0.3
945,3,5,2,11,18,0.2777777777777778
946,1,6,7,9,22,0.2727272727272727
947,3,3,0,4,7,0.4285714285714285
948,1,1,0,2,3,0.3333333333333333
949,6,10,2,6,18,0.5555555555555556
950,1,3,4,10,17,0.1764705882352941
951,4,3,0,4,7,0.4285714285714285
952,3,3,0,4,7,0.4285714285714285
953,3,7,1,7,15,0.4666666666666667
954,1,4,6,13,23,0.1739130434782608
955,1,2,4,12,18,0.1111111111111111
956,7,6,3,5,14,0.4285714285714285
957,3,2,0,4,6,0.3333333333333333
958,5,10,6,7,23,0.4347826086956521
959,1,0,1,2,3,0.0
960,1,2,0,3,5,0.4
961,3,11,6,9,26,0.4230769230769231
962,1,5,11,6,22,0.2272727272727272
963,2,4,2,8,14,0.2857142857142857
964,1,5,6,7,18,0.2777777777777778
965,1,9,7,9,25,0.36
966,1,4,9,13,26,0.1538461538461538
967,2,2,0,3,5,0.4
968,1,2,4,10,16,0.125
969,1,0,0,3,3,0.0
970,5,10,1,6,17,0.5882352941176471
971,4,5,3,12,20,0.25
972,2,1,1,4,6,0.1666666666666666
973,1,1,0,2,3,0.3333333333333333
974,1,8,4,10,22,0.3636363636363636
975,3,2,1,3,6,0.3333333333333333
976,3,8,8,6,22,0.3636363636363636
977,4,3,1,8,12,0.25
978,1,6,4,9,19,0.3157894736842105
979,1,4,3,4,11,0.3636363636363636
980,5,8,5,4,17,0.4705882352941176
981,2,2,0,3,5,0.4
982,5,5,2,4,11,0.4545454545454545
983,6,3,8,4,15,0.2
984,2,6,5,10,21,0.2857142857142857
985,1,4,4,11,19,0.2105263157894736
986,4,3,1,2,6,0.5
987,1,1,0,2,3,0.3333333333333333
988,1,10,2,8,20,0.5
989,1,1,1,5,7,0.1428571428571428
990,7,6,1,4,11,0.5454545454545454
991,1,3,0,3,6,0.5
992,3,2,0,4,6,0.3333333333333333
993,1,4,2,8,14,0.2857142857142857
994,1,6,6,7,19,0.3157894736842105
995,1,2,1,7,10,0.2
996,1,1,0,3,4,0.25
997,1,2,1,4,7,0.2857142857142857
998,3,3,1,3,7,0.4285714285714285
999,1,2,0,3,5,0.4
1000,7,11,3,4,18,0.6111111111111112
1001,1,1,1,3,5,0.2
1002,2,2,1,2,5,0.4
1003,3,5,4,9,18,0.2777777777777778
1004,1,2,2,2,6,0.3333333333333333
1005,2,2,1,2,5,0.4
1006,1,1,0,3,4,0.25
1007,5,10,7,10,27,0.3703703703703703
1008,1,8,8,5,21,0.3809523809523809
1009,1,8,6,5,19,0.4210526315789473
1010,1,4,4,7,15,0.2666666666666666
1011,1,1,0,3,4,0.25
1012,1,5,6,7,18,0.2777777777777778
1013,2,5,1,5,11,0.4545454545454545
1014,4,3,0,4,7,0.4285714285714285
1015,3,2,0,4,6,0.3333333333333333
1016,1,1,2,2,5,0.2
1017,4,6,3,8,17,0.3529411764705882
1018,2,5,5,6,16,0.3125
1019,3,2,0,3,5,0.4
1020,15,0,1,0,1,0.0
1021,1,4,5,4,13,0.3076923076923077
1022,1,1,1,2,4,0.25
1023,3,2,1,4,7,0.2857142857142857
1024,1,2,0,4,6,0.3333333333333333
1025,1,7,7,12,26,0.2692307692307692
1026,6,6,1,5,12,0.5
1027,6,6,2,11,19,0.3157894736842105
1028,1,6,6,7,19,0.3157894736842105
1029,1,1,0,2,3,0.3333333333333333
1030,1,7,8,9,24,0.2916666666666667
1031,2,1,2,2,5,0.2
1032,1,1,0,3,4,0.25
1033,1,3,5,12,20,0.15
1034,4,6,1,4,11,0.5454545454545454
1035,1,5,1,5,11,0.4545454545454545
1036,1,6,7,8,21,0.2857142857142857
1037,1,2,8,6,16,0.125
1038,11,3,4,10,17,0.1764705882352941
1039,2,7,6,11,24,0.2916666666666667
1040,2,5,2,11,18,0.2777777777777778
1041,2,1,1,2,4,0.25
1042,1,4,4,8,16,0.25
1043,3,1,1,3,5,0.2
1044,1,4,10,8,22,0.1818181818181818
1045,8,8,9,8,25,0.32
1046,1,1,0,2,3,0.3333333333333333
1047,1,3,7,13,23,0.1304347826086956
1048,2,3,0,3,6,0.5
1049,6,5,6,8,19,0.2631578947368421
1050,3,9,2,9,20,0.45
1051,2,2,0,3,5,0.4
1052,1,6,1,6,13,0.4615384615384615
1053,1,4,7,9,20,0.2
1054,1,6,7,11,24,0.25
1055,2,1,0,3,4,0.25
1056,2,4,1,8,13,0.3076923076923077
1057,1,1,0,2,3,0.3333333333333333
1058,1,4,3,5,12,0.3333333333333333
1059,6,7,2,4,13,0.5384615384615384
1060,1,5,6,4,15,0.3333333333333333
1061,1,0,0,3,3,0.0
1062,1,5,8,6,19,0.2631578947368421
1063,4,11,6,5,22,0.5
1064,2,1,0,3,4,0.25
1065,0,9,9,4,22,0.4090909090909091
1066,1,1,0,2,3,0.3333333333333333
1067,1,4,7,5,16,0.25
1068,1,6,6,7,19,0.3157894736842105
1069,2,2,1,4,7,0.2857142857142857
1070,1,4,5,7,16,0.25
1071,3,3,0,3,6,0.5
1072,3,2,1,4,7,0.2857142857142857
1073,1,4,2,8,14,0.2857142857142857
1074,1,4,3,5,12,0.3333333333333333
1075,1,3,3,8,14,0.2142857142857142
1076,1,1,0,2,3,0.3333333333333333
1077,2,5,8,10,23,0.217391304347826
1078,0,4,7,6,17,0.2352941176470588
1079,2,4,1,7,12,0.3333333333333333
1080,6,7,2,5,14,0.5
1081,2,4,1,6,11,0.3636363636363636
1082,1,2,0,3,5,0.4
1083,1,4,5,11,20,0.2
1084,1,2,0,3,5,0.4
1085,2,2,0,4,6,0.3333333333333333
1086,2,6,2,9,17,0.3529411764705882
1087,7,4,1,7,12,0.3333333333333333
1088,1,2,2,11,15,0.1333333333333333
1089,1,8,2,5,15,0.5333333333333333
1090,1,1,0,2,3,0.3333333333333333
1091,0,4,6,9,19,0.2105263157894736
1092,3,3,0,3,6,0.5
1093,3,3,3,5,11,0.2727272727272727
1094,1,1,1,2,4,0.25
1095,1,3,5,3,11,0.2727272727272727
1096,1,2,1,2,5,0.4
1097,5,11,1,6,18,0.6111111111111112
1098,2,6,5,9,20,0.3
1099,2,2,1,4,7,0.2857142857142857
1100,5,4,2,5,11,0.3636363636363636
1101,1,2,1,4,7,0.2857142857142857
1102,2,6,1,5,12,0.5
1103,7,6,2,5,13,0.4615384615384615
1104,4,5,3,6,14,0.3571428571428571
1105,2,1,1,3,5,0.2
1106,1,0,0,3,3,0.0
1107,1,7,6,11,24,0.2916666666666667
1108,4,2,2,9,13,0.1538461538461538
1109,1,1,0,2,3,0.3333333333333333
1110,1,1,0,3,4,0.25
1111,2,6,7,9,22,0.2727272727272727
1112,1,7,5,8,20,0.35
1113,2,5,1,6,12,0.4166666666666667
1114,3,3,0,3,6,0.5
1115,1,4,6,9,19,0.2105263157894736
1116,2,3,0,3,6,0.5
1117,2,6,2,4,12,0.5
1118,4,6,2,10,18,0.3333333333333333
1119,1,2,0,4,6,0.3333333333333333
1120,2,2,1,2,5,0.4
1121,2,2,0,4,6,0.3333333333333333
1122,1,6,5,13,24,0.25
1123,4,2,1,4,7,0.2857142857142857
1124,2,3,1,3,7,0.4285714285714285
1125,12,9,2,8,19,0.4736842105263157
1126,2,9,1,4,14,0.6428571428571429
1127,1,1,0,2,3,0.3333333333333333
1128,2,9,3,13,25,0.36
1129,3,10,4,7,21,0.4761904761904761
1130,1,1,0,2,3,0.3333333333333333
1131,1,5,9,11,25,0.2
1132,2,1,3,6,10,0.1
1133,4,2,1,3,6,0.3333333333333333
1134,10,5,2,9,16,0.3125
1135,1,7,3,4,14,0.5
1136,1,3,2,5,10,0.3
1137,2,7,6,10,23,0.3043478260869565
1138,1,4,1,6,11,0.3636363636363636
1139,12,9,2,8,19,0.4736842105263157
1140,1,8,1,7,16,0.5
1141,1,6,4,10,20,0.3
1142,2,4,1,5,10,0.4
1143,4,4,2,12,18,0.2222222222222222
1144,1,1,1,3,5,0.2
1145,3,2,0,4,6,0.3333333333333333
1146,1,4,4,8,16,0.25
1147,1,3,4,8,15,0.2
1148,1,1,0,2,3,0.3333333333333333
1149,1,1,0,3,4,0.25
1150,1,8,2,5,15,0.5333333333333333
1151,3,8,2,4,14,0.5714285714285714
1152,2,2,0,3,5,0.4
1153,3,2,2,6,10,0.2
1154,1,1,0,2,3,0.3333333333333333
1155,2,3,2,10,15,0.2
1156,3,2,0,4,6,0.3333333333333333
1157,1,3,4,10,17,0.1764705882352941
1158,3,8,2,6,16,0.5
1159,1,4,1,5,10,0.4
1160,3,9,5,4,18,0.5
1161,5,2,2,3,7,0.2857142857142857
1162,1,1,0,2,3,0.3333333333333333
1163,1,1,0,3,4,0.25
1164,2,1,0,4,5,0.2
1165,1,6,6,13,25,0.24
1166,2,3,1,4,8,0.375
1167,1,1,0,3,4,0.25
1168,1,5,6,4,15,0.3333333333333333
1169,4,7,4,10,21,0.3333333333333333
1170,1,1,2,2,5,0.2
1171,1,4,0,4,8,0.5
1172,3,2,1,4,7,0.2857142857142857
1173,1,9,3,9,21,0.4285714285714285
1174,1,2,1,4,7,0.2857142857142857
1175,2,5,2,10,17,0.2941176470588235
1176,1,3,5,5,13,0.2307692307692307
1177,3,6,6,12,24,0.25
1178,4,2,1,5,8,0.25
1179,3,9,2,8,19,0.4736842105263157
1180,2,3,2,4,9,0.3333333333333333
1181,2,1,1,2,4,0.25
1182,1,3,4,9,16,0.1875
1183,3,10,4,5,19,0.5263157894736842
1184,1,6,9,10,25,0.24
1185,1,2,0,3,5,0.4
1186,1,1,1,2,4,0.25
1187,2,3,0,4,7,0.4285714285714285
1188,2,5,1,7,13,0.3846153846153846
1189,2,2,4,10,16,0.125
1190,2,7,11,11,29,0.2413793103448276
1191,1,5,9,6,20,0.25
1192,5,4,1,5,10,0.4
1193,4,2,1,4,7,0.2857142857142857
1194,1,4,2,10,16,0.25
1195,5,3,1,4,8,0.375
1196,1,4,9,10,23,0.1739130434782608
1197,2,2,2,2,6,0.3333333333333333
1198,3,3,1,3,7,0.4285714285714285
1199,1,1,0,2,3,0.3333333333333333
1200,1,5,7,9,21,0.238095238095238
1201,2,2,1,2,5,0.4
1202,4,2,1,4,7,0.2857142857142857
1203,2,5,4,9,18,0.2777777777777778
1204,1,11,2,8,21,0.5238095238095238
1205,2,2,1,2,5,0.4
1206,5,4,1,8,13,0.3076923076923077
1207,3,3,0,3,6,0.5
1208,5,5,0,4,9,0.5555555555555556
1209,1,1,0,3,4,0.25
1210,3,3,0,4,7,0.4285714285714285
1211,2,2,0,3,5,0.4
1212,1,1,0,3,4,0.25
1213,4,8,2,11,21,0.3809523809523809
1214,1,2,1,4,7,0.2857142857142857
1215,1,5,6,12,23,0.217391304347826
1216,1,1,0,3,4,0.25
1217,4,2,1,5,8,0.25
1218,1,1,0,3,4,0.25
1219,2,2,0,3,5,0.4
1220,1,5,10,7,22,0.2272727272727272
1221,1,1,3,5,9,0.1111111111111111
1222,4,6,2,4,12,0.5
1223,4,3,2,2,7,0.4285714285714285
1224,1,0,1,2,3,0.0
1225,1,1,0,2,3,0.3333333333333333
1226,3,8,3,13,24,0.3333333333333333
1227,1,4,2,6,12,0.3333333333333333
1228,4,6,5,13,24,0.25
1229,2,11,10,11,32,0.34375
1230,2,7,3,5,15,0.4666666666666667
1231,2,8,9,4,21,0.3809523809523809
1232,4,7,2,5,14,0.5
1233,2,7,4,3,14,0.5
1234,2,4,2,11,17,0.2352941176470588
1235,1,1,0,2,3,0.3333333333333333
1236,1,4,7,11,22,0.1818181818181818
1237,2,1,1,2,4,0.25
1238,1,6,2,8,16,0.375
1239,1,7,8,11,26,0.2692307692307692
1240,3,2,0,3,5,0.4
1241,2,2,1,2,5,0.4
1242,0,4,7,6,17,0.2352941176470588
1243,10,9,4,6,19,0.4736842105263157
1244,3,2,1,3,6,0.3333333333333333
1245,1,4,1,4,9,0.4444444444444444
1246,1,6,6,6,18,0.3333333333333333
1247,2,7,3,4,14,0.5
1248,3,5,3,13,21,0.238095238095238
1249,4,5,1,4,10,0.5
1250,8,9,1,7,17,0.5294117647058824
1251,3,2,1,3,6,0.3333333333333333
1252,4,3,4,11,18,0.1666666666666666
1253,1,1,0,2,3,0.3333333333333333
1254,2,3,0,3,6,0.5
1255,0,6,7,9,22,0.2727272727272727
1256,5,5,1,7,13,0.3846153846153846
1257,1,4,6,8,18,0.2222222222222222
1258,2,9,7,10,26,0.3461538461538461
1259,2,1,0,3,4,0.25
1260,2,7,1,7,15,0.4666666666666667
1261,2,4,2,5,11,0.3636363636363636
1262,1,1,0,3,4,0.25
1263,2,9,2,5,16,0.5625
1264,2,1,2,2,5,0.2
1265,1,5,7,10,22,0.2272727272727272
1266,2,7,2,10,19,0.3684210526315789
1267,1,1,0,2,3,0.3333333333333333
1268,1,2,0,2,4,0.5
1269,2,2,0,4,6,0.3333333333333333
1270,1,1,0,2,3,0.3333333333333333
1271,2,1,0,4,5,0.2
1272,2,2,1,5,8,0.25
1273,1,2,0,2,4,0.5
1274,5,7,2,11,20,0.35
1275,1,4,6,4,14,0.2857142857142857
1276,4,2,1,3,6,0.3333333333333333
1277,0,1,0,1,2,0.5
1278,0,5,8,5,18,0.2777777777777778
1279,1,2,0,3,5,0.4
1280,5,5,2,4,11,0.4545454545454545
1281,1,5,5,8,18,0.2777777777777778
1282,5,10,3,8,21,0.4761904761904761
1283,6,7,1,5,13,0.5384615384615384
1284,1,5,5,12,22,0.2272727272727272
1285,1,10,4,13,27,0.3703703703703703
1286,7,11,2,12,25,0.44
1287,2,5,4,10,19,0.2631578947368421
1288,1,7,5,10,22,0.3181818181818182
1289,3,6,1,5,12,0.5
1290,5,4,7,10,21,0.1904761904761904
1291,3,3,1,7,11,0.2727272727272727
1292,3,3,0,3,6,0.5
1293,4,3,2,8,13,0.2307692307692307
1294,1,1,0,3,4,0.25
1295,2,3,0,3,6,0.5
1296,1,1,1,2,4,0.25
1297,1,5,9,12,26,0.1923076923076923
1298,3,6,1,5,12,0.5
1299,2,5,7,12,24,0.2083333333333333
1300,4,7,2,3,12,0.5833333333333334
1301,2,3,0,3,6,0.5
1302,6,6,3,13,22,0.2727272727272727
1303,1,3,0,3,6,0.5
1304,1,3,1,4,8,0.375
1305,0,1,0,1,2,0.5
1306,1,8,3,5,16,0.5
1307,2,2,2,2,6,0.3333333333333333
1308,5,6,1,5,12,0.5
1309,3,7,4,7,18,0.3888888888888889
1310,1,4,9,13,26,0.1538461538461538
1311,1,6,5,8,19,0.3157894736842105
1312,2,5,2,4,11,0.4545454545454545
1313,1,2,8,6,16,0.125
1314,1,3,1,3,7,0.4285714285714285
1315,1,1,0,3,4,0.25
1316,3,7,1,3,11,0.6363636363636364
1317,1,5,1,6,12,0.4166666666666667
1318,3,5,2,6,13,0.3846153846153846
1319,11,3,4,10,17,0.1764705882352941
1320,1,1,0,4,5,0.2
1321,1,1,0,2,3,0.3333333333333333
1322,2,2,1,3,6,0.3333333333333333
1323,1,1,0,3,4,0.25
1324,2,5,2,7,14,0.3571428571428571
1325,3,10,4,7,21,0.4761904761904761
1326,1,4,6,9,19,0.2105263157894736
1327,1,4,8,10,22,0.1818181818181818
1328,1,6,6,4,16,0.375
1329,1,0,1,2,3,0.0
1330,1,4,1,5,10,0.4
1331,1,6,6,7,19,0.3157894736842105
1332,2,8,2,11,21,0.3809523809523809
1333,2,3,1,2,6,0.5
1334,1,6,2,10,18,0.3333333333333333
1335,1,5,8,5,18,0.2777777777777778
1336,3,2,1,4,7,0.2857142857142857
1337,6,8,2,6,16,0.5
1338,2,2,1,2,5,0.4
1339,8,6,1,7,14,0.4285714285714285
1340,1,8,7,11,26,0.3076923076923077
1341,4,2,2,7,11,0.1818181818181818
1342,1,6,3,6,15,0.4
1343,3,6,3,5,14,0.4285714285714285
1344,1,1,0,3,4,0.25
1345,3,4,1,4,9,0.4444444444444444
1346,1,3,2,5,10,0.3
1347,2,4,1,5,10,0.4
1348,2,2,0,4,6,0.3333333333333333
1349,2,1,0,3,4,0.25
1350,6,4,5,7,16,0.25
1351,5,8,4,11,23,0.3478260869565217
1352,4,7,2,4,13,0.5384615384615384
1353,6,4,2,8,14,0.2857142857142857
1354,2,2,1,2,5,0.4
1355,3,5,1,6,12,0.4166666666666667
1356,1,4,2,3,9,0.4444444444444444
1357,4,3,1,4,8,0.375
1358,1,2,0,3,5,0.4
1359,0,5,10,5,20,0.25
1360,2,1,0,3,4,0.25
1361,1,1,0,3,4,0.25
1362,1,8,6,6,20,0.4
1363,6,4,4,3,11,0.3636363636363636
1364,3,2,1,4,7,0.2857142857142857
1365,1,1,0,3,4,0.25
1366,2,1,1,2,4,0.25
1367,2,2,0,3,5,0.4
1368,2,6,3,12,21,0.2857142857142857
1369,1,1,0,2,3,0.3333333333333333
1370,2,2,1,3,6,0.3333333333333333
1371,1,9,3,9,21,0.4285714285714285
1372,2,6,2,4,12,0.5
1373,4,5,1,5,11,0.4545454545454545
1374,1,9,2,9,20,0.45
1375,2,4,1,3,8,0.5
1376,3,5,2,4,11,0.4545454545454545
1377,6,8,4,8,20,0.4
1378,4,3,0,4,7,0.4285714285714285
1379,4,6,1,5,12,0.5
1380,2,7,5,8,20,0.35
1381,3,4,2,9,15,0.2666666666666666
1382,4,3,2,2,7,0.4285714285714285
1383,1,7,2,12,21,0.3333333333333333
1384,2,5,3,6,14,0.3571428571428571
1385,1,1,0,2,3,0.3333333333333333
1386,1,5,10,5,20,0.25
1387,3,5,0,3,8,0.625
1388,4,4,3,8,15,0.2666666666666666
1389,1,2,1,2,5,0.4
1390,1,2,2,5,9,0.2222222222222222
1391,2,2,0,3,5,0.4
1392,3,2,0,4,6,0.3333333333333333
1393,1,1,0,2,3,0.3333333333333333
1394,1,2,10,10,22,0.0909090909090909
1395,4,4,3,12,19,0.2105263157894736
1396,1,1,0,3,4,0.25
1397,1,1,1,2,4,0.25
1398,3,2,0,4,6,0.3333333333333333
1399,1,1,0,2,3,0.3333333333333333
1400,1,1,0,2,3,0.3333333333333333
1401,2,2,0,3,5,0.4
1402,1,6,1,6,13,0.4615384615384615
1403,1,1,0,3,4,0.25
1404,1,1,0,3,4,0.25
1405,1,6,5,11,22,0.2727272727272727
1406,2,2,0,3,5,0.4
1407,5,6,1,5,12,0.5
1408,2,1,1,2,4,0.25
1409,4,5,1,5,11,0.4545454545454545
1410,1,0,1,2,3,0.0
1411,1,1,1,4,6,0.1666666666666666
1412,2,3,0,4,7,0.4285714285714285
1413,3,2,1,3,6,0.3333333333333333
1414,1,1,0,2,3,0.3333333333333333
1415,3,3,0,3,6,0.5
1416,3,3,7,10,20,0.15
1417,1,7,5,10,22,0.3181818181818182
1418,1,2,2,8,12,0.1666666666666666
1419,1,4,4,9,17,0.2352941176470588
1420,4,10,7,5,22,0.4545454545454545
1421,1,4,4,8,16,0.25
1422,4,4,4,5,13,0.3076923076923077
1423,3,3,2,4,9,0.3333333333333333
1424,1,3,4,9,16,0.1875
1425,1,3,11,8,22,0.1363636363636363
1426,1,2,0,3,5,0.4
1427,2,7,3,5,15,0.4666666666666667
1428,1,4,4,7,15,0.2666666666666666
1429,3,4,0,4,8,0.5
1430,4,2,0,4,6,0.3333333333333333
1431,0,6,7,12,25,0.24
1432,2,5,2,9,16,0.3125
1433,4,7,3,7,17,0.4117647058823529
1434,7,4,6,8,18,0.2222222222222222
1435,1,1,0,3,4,0.25
1436,3,3,0,3,6,0.5
1437,1,1,0,3,4,0.25
1438,4,2,11,5,18,0.1111111111111111
1439,4,8,1,8,17,0.4705882352941176
1440,1,4,4,11,19,0.2105263157894736
1441,1,0,0,3,3,0.0
1442,4,9,4,8,21,0.4285714285714285
1443,3,1,1,3,5,0.2
1444,4,4,1,3,8,0.5
1445,1,1,0,3,4,0.25
1446,1,8,5,4,17,0.4705882352941176
1447,2,6,6,7,19,0.3157894736842105
1448,2,3,0,4,7,0.4285714285714285
1449,1,7,5,10,22,0.3181818181818182
1450,1,2,1,3,6,0.3333333333333333
1451,1,3,2,4,9,0.3333333333333333
1452,2,7,5,13,25,0.28
1453,7,10,2,12,24,0.4166666666666667
1454,3,5,3,12,20,0.25
1455,1,1,0,3,4,0.25
1456,2,1,0,3,4,0.25
1457,2,7,3,6,16,0.4375
1458,3,6,3,13,22,0.2727272727272727
1459,1,4,6,4,14,0.2857142857142857
1460,7,8,2,5,15,0.5333333333333333
1461,2,11,8,8,27,0.4074074074074074
1462,5,6,2,5,13,0.4615384615384615
1463,10,7,4,9,20,0.35
1464,4,6,1,4,11,0.5454545454545454
1465,1,7,11,10,28,0.25
1466,7,7,2,9,18,0.3888888888888889
1467,2,2,0,4,6,0.3333333333333333
1468,2,4,7,13,24,0.1666666666666666
1469,1,2,0,3,5,0.4
1470,6,4,2,9,15,0.2666666666666666
1471,4,9,5,7,21,0.4285714285714285
1472,1,9,7,13,29,0.3103448275862069
1473,7,4,3,5,12,0.3333333333333333
1474,1,1,0,3,4,0.25
1475,6,7,1,6,14,0.5
1476,13,8,2,9,19,0.4210526315789473
1477,2,5,10,5,20,0.25
1478,1,4,3,6,13,0.3076923076923077
1479,9,5,2,10,17,0.2941176470588235
1480,6,11,8,5,24,0.4583333333333333
1481,1,2,8,13,23,0.0869565217391304
1482,5,5,5,12,22,0.2272727272727272
1483,1,3,4,10,17,0.1764705882352941
1484,4,3,2,2,7,0.4285714285714285
1485,3,10,4,9,23,0.4347826086956521
1486,1,4,8,9,21,0.1904761904761904
1487,1,3,1,2,6,0.5
1488,2,4,2,4,10,0.4
1489,5,10,3,8,21,0.4761904761904761
1490,1,2,0,4,6,0.3333333333333333
1491,1,3,0,3,6,0.5
1492,2,2,0,3,5,0.4
1493,1,10,2,6,18,0.5555555555555556
1494,1,4,5,12,21,0.1904761904761904
1495,1,2,1,3,6,0.3333333333333333
1496,2,2,0,3,5,0.4
1497,12,7,4,9,20,0.35
1498,0,4,6,7,17,0.2352941176470588
1499,3,2,2,2,6,0.3333333333333333
1500,1,4,6,4,14,0.2857142857142857
1501,2,1,1,3,5,0.2
1502,4,6,3,13,22,0.2727272727272727
1503,6,5,1,5,11,0.4545454545454545
1504,4,7,3,13,23,0.3043478260869565
1505,4,3,2,2,7,0.4285714285714285
1506,2,3,0,3,6,0.5
1507,6,5,1,5,11,0.4545454545454545
1508,1,1,1,2,4,0.25
1509,1,3,6,6,15,0.2
1510,3,3,4,9,16,0.1875
1511,3,11,2,12,25,0.44
1512,2,3,0,4,7,0.4285714285714285
1513,4,9,2,12,23,0.391304347826087
1514,1,5,4,10,19,0.2631578947368421
1515,1,0,0,3,3,0.0
1516,3,9,2,10,21,0.4285714285714285
1517,1,3,0,3,6,0.5
1518,1,2,0,3,5,0.4
1519,1,4,0,3,7,0.5714285714285714
1520,2,8,3,7,18,0.4444444444444444
1521,1,0,0,3,3,0.0
1522,1,1,1,4,6,0.1666666666666666
1523,1,4,4,7,15,0.2666666666666666
1524,1,6,4,6,16,0.375
1525,1,4,5,4,13,0.3076923076923077
1526,5,9,6,12,27,0.3333333333333333
1527,2,1,0,3,4,0.25
1528,7,4,2,4,10,0.4
1529,1,1,0,2,3,0.3333333333333333
1530,4,2,1,4,7,0.2857142857142857
1531,3,7,3,13,23,0.3043478260869565
1532,2,3,0,4,7,0.4285714285714285
1533,6,7,1,7,15,0.4666666666666667
1534,1,1,0,2,3,0.3333333333333333
1535,1,5,10,5,20,0.25
1536,2,3,0,3,6,0.5
1537,2,6,3,5,14,0.4285714285714285
1538,4,5,4,10,19,0.2631578947368421
1539,2,5,4,12,21,0.238095238095238
1540,5,11,1,6,18,0.6111111111111112
1541,11,6,3,5,14,0.4285714285714285
1542,1,7,6,12,25,0.28
1543,3,2,0,3,5,0.4
1544,1,3,4,10,17,0.1764705882352941
1545,1,1,0,3,4,0.25
1546,6,7,1,6,14,0.5
1547,4,5,1,5,11,0.4545454545454545
1548,1,3,1,3,7,0.4285714285714285
1549,1,4,5,8,17,0.2352941176470588
1550,1,2,1,4,7,0.2857142857142857
1551,1,7,2,7,16,0.4375
1552,1,1,0,2,3,0.3333333333333333
1553,1,4,7,5,16,0.25
1554,1,5,3,6,14,0.3571428571428571
1555,2,2,1,3,6,0.3333333333333333
1556,1,3,10,13,26,0.1153846153846153
1557,2,1,1,2,4,0.25
1558,4,3,1,4,8,0.375
1559,1,3,2,6,11,0.2727272727272727
1560,7,3,2,5,10,0.3
1561,1,7,5,12,24,0.2916666666666667
1562,2,3,1,4,8,0.375
1563,1,4,3,5,12,0.3333333333333333
1564,1,2,0,2,4,0.5
1565,3,6,1,5,12,0.5
1566,1,2,0,4,6,0.3333333333333333
1567,5,7,1,6,14,0.5
1568,5,3,0,4,7,0.4285714285714285
1569,3,7,1,4,12,0.5833333333333334
1570,1,2,5,13,20,0.1
1571,1,1,1,3,5,0.2
1572,4,8,5,3,16,0.5
1573,1,4,7,12,23,0.1739130434782608
1574,1,4,5,10,19,0.2105263157894736
1575,2,1,0,3,4,0.25
1576,2,2,0,3,5,0.4
1577,1,2,0,2,4,0.5
1578,4,5,5,11,21,0.238095238095238
1579,5,10,5,4,19,0.5263157894736842
1580,5,7,2,5,14,0.5
1581,1,4,4,8,16,0.25
1582,1,4,5,11,20,0.2
1583,1,2,0,3,5,0.4
1584,1,6,3,9,18,0.3333333333333333
1585,4,5,1,5,11,0.4545454545454545
1586,2,1,1,2,4,0.25
1587,3,5,3,13,21,0.238095238095238
1588,1,1,0,2,3,0.3333333333333333
1589,2,3,2,7,12,0.25
1590,1,4,1,5,10,0.4
1591,7,9,6,9,24,0.375
1592,1,3,0,4,7,0.4285714285714285
1593,3,2,0,4,6,0.3333333333333333
1594,1,5,7,6,18,0.2777777777777778
1595,9,8,1,6,15,0.5333333333333333
1596,4,3,1,5,9,0.3333333333333333
1597,2,5,1,4,10,0.5
1598,6,3,2,10,15,0.2
1599,1,6,2,8,16,0.375
1600,3,4,1,2,7,0.5714285714285714
1601,1,3,0,3,6,0.5
1602,1,9,3,13,25,0.36
1603,3,4,1,5,10,0.4
1604,2,2,1,4,7,0.2857142857142857
1605,1,1,0,2,3,0.3333333333333333
1606,2,4,6,4,14,0.2857142857142857
1607,6,11,2,7,20,0.55
1608,2,8,2,7,17,0.4705882352941176
1609,1,3,6,12,21,0.1428571428571428
1610,2,2,0,3,5,0.4
1611,1,1,0,3,4,0.25
1612,1,1,0,3,4,0.25
1613,5,2,5,6,13,0.1538461538461538
1614,8,9,1,7,17,0.5294117647058824
1615,1,1,0,3,4,0.25
1616,1,7,5,8,20,0.35
1617,1,0,0,3,3,0.0
1618,2,6,2,6,14,0.4285714285714285
1619,1,5,3,12,20,0.25
1620,1,7,5,7,19,0.3684210526315789
1621,3,2,1,4,7,0.2857142857142857
1622,3,2,1,3,6,0.3333333333333333
1623,1,3,6,12,21,0.1428571428571428
1624,3,3,1,2,6,0.5
1625,0,0,28,0,28,0.0
1626,2,1,0,3,4,0.25
1627,1,2,0,3,5,0.4
1628,3,5,2,5,12,0.4166666666666667
1629,1,5,3,13,21,0.238095238095238
1630,6,7,4,6,17,0.4117647058823529
1631,1,4,6,6,16,0.25
1632,9,6,2,7,15,0.4
1633,4,5,1,3,9,0.5555555555555556
1634,2,6,4,12,22,0.2727272727272727
1635,3,3,1,2,6,0.5
1636,1,1,1,3,5,0.2
1637,1,2,0,3,5,0.4
1638,1,6,3,12,21,0.2857142857142857
1639,3,1,1,4,6,0.1666666666666666
1640,2,7,3,13,23,0.3043478260869565
1641,2,11,10,11,32,0.34375
1642,2,4,2,5,11,0.3636363636363636
1643,1,5,6,6,17,0.2941176470588235
1644,1,7,4,10,21,0.3333333333333333
1645,1,6,8,6,20,0.3
1646,4,8,9,13,30,0.2666666666666666
1647,1,1,1,4,6,0.1666666666666666
1648,4,5,1,4,10,0.5
1649,1,1,0,3,4,0.25
1650,2,5,1,8,14,0.3571428571428571
1651,1,2,0,3,5,0.4
1652,1,5,10,7,22,0.2272727272727272
1653,4,3,1,3,7,0.4285714285714285
1654,4,2,0,4,6,0.3333333333333333
1655,1,0,0,3,3,0.0
1656,2,4,2,5,11,0.3636363636363636
1657,1,1,0,3,4,0.25
1658,1,4,6,5,15,0.2666666666666666
1659,4,10,4,7,21,0.4761904761904761
1660,4,8,3,12,23,0.3478260869565217
1661,1,3,7,11,21,0.1428571428571428
1662,3,7,2,9,18,0.3888888888888889
1663,1,8,4,6,18,0.4444444444444444
1664,1,1,0,2,3,0.3333333333333333
1665,1,1,0,2,3,0.3333333333333333
1666,1,2,0,3,5,0.4
1667,2,3,3,13,19,0.1578947368421052
1668,1,1,0,2,3,0.3333333333333333
1669,0,4,2,5,11,0.3636363636363636
1670,1,1,0,3,4,0.25
1671,2,9,6,8,23,0.391304347826087
1672,5,8,4,11,23,0.3478260869565217
1673,3,3,0,3,6,0.5
1674,3,3,0,4,7,0.4285714285714285
1675,6,8,2,9,19,0.4210526315789473
1676,4,3,1,3,7,0.4285714285714285
1677,3,3,1,4,8,0.375
1678,4,7,8,13,28,0.25
1679,2,5,2,4,11,0.4545454545454545
1680,1,7,2,10,19,0.3684210526315789
1681,1,3,3,5,11,0.2727272727272727
1682,1,4,7,10,21,0.1904761904761904
1683,1,8,7,7,22,0.3636363636363636
1684,1,1,0,4,5,0.2
1685,1,5,8,12,25,0.2
1686,2,3,0,3,6,0.5
1687,6,6,1,5,12,0.5
1688,2,6,3,6,15,0.4
1689,2,2,0,3,5,0.4
1690,5,4,1,4,9,0.4444444444444444
1691,4,7,5,9,21,0.3333333333333333
1692,1,1,0,2,3,0.3333333333333333
1693,1,7,5,12,24,0.2916666666666667
1694,1,5,6,7,18,0.2777777777777778
1695,0,6,5,13,24,0.25
1696,5,6,1,5,12,0.5
1697,3,2,1,3,6,0.3333333333333333
1698,5,4,1,6,11,0.3636363636363636
1699,1,1,1,2,4,0.25
1700,4,9,2,12,23,0.391304347826087
1701,2,7,6,13,26,0.2692307692307692
1702,2,2,0,3,5,0.4
1703,1,1,1,2,4,0.25
1704,1,1,1,2,4,0.25
1705,1,3,5,12,20,0.15
1706,1,5,2,10,17,0.2941176470588235
1707,4,7,10,5,22,0.3181818181818182
1708,2,8,1,8,17,0.4705882352941176
1709,1,4,5,13,22,0.1818181818181818
1710,4,6,1,6,13,0.4615384615384615
1711,1,1,0,3,4,0.25
1712,2,4,1,3,8,0.5
1713,5,6,3,5,14,0.4285714285714285
1714,1,3,1,3,7,0.4285714285714285
1715,1,6,5,13,24,0.25
1716,2,11,3,7,21,0.5238095238095238
1717,1,4,11,7,22,0.1818181818181818
1718,1,1,0,2,3,0.3333333333333333
1719,1,6,4,13,23,0.2608695652173913
1720,3,7,3,10,20,0.35
1721,2,4,4,5,13,0.3076923076923077
1722,3,8,3,5,16,0.5
1723,5,5,1,5,11,0.4545454545454545
1724,1,1,0,3,4,0.25
1725,4,7,1,7,15,0.4666666666666667
1726,3,2,0,3,5,0.4
1727,4,1,1,4,6,0.1666666666666666
1728,3,2,1,3,6,0.3333333333333333
1729,2,5,1,2,8,0.625
1730,2,1,0,4,5,0.2
1731,3,7,4,7,18,0.3888888888888889
1732,3,7,2,8,17,0.4117647058823529
1733,2,2,0,3,5,0.4
1734,2,3,3,8,14,0.2142857142857142
1735,1,9,7,9,25,0.36
1736,2,2,1,3,6,0.3333333333333333
1737,3,9,2,12,23,0.391304347826087
1738,1,1,0,3,4,0.25
1739,1,2,8,6,16,0.125
1740,1,2,0,3,5,0.4
1741,2,3,2,3,8,0.375
1742,3,3,0,3,6,0.5
1743,1,4,1,4,9,0.4444444444444444
1744,1,3,5,12,20,0.15
1745,1,1,0,3,4,0.25
1746,5,4,1,6,11,0.3636363636363636
1747,4,3,1,4,8,0.375
1748,2,5,1,5,11,0.4545454545454545
1749,1,3,1,2,6,0.5
1750,1,2,3,13,18,0.1111111111111111
1751,2,2,0,3,5,0.4
1752,3,2,1,4,7,0.2857142857142857
1753,1,9,4,10,23,0.391304347826087
1754,2,11,2,10,23,0.4782608695652174
1755,5,5,2,5,12,0.4166666666666667
1756,4,5,1,4,10,0.5
1757,5,6,3,6,15,0.4
1758,1,2,0,4,6,0.3333333333333333
1759,13,2,2,12,16,0.125
1760,1,6,6,11,23,0.2608695652173913
1761,3,2,1,3,6,0.3333333333333333
1762,2,1,0,4,5,0.2
1763,1,3,9,13,25,0.12
1764,1,2,1,3,6,0.3333333333333333
1765,5,3,3,3,9,0.3333333333333333
1766,1,1,1,2,4,0.25
1767,1,3,2,8,13,0.2307692307692307
1768,2,3,0,3,6,0.5
1769,2,6,3,4,13,0.4615384615384615
1770,1,7,5,8,20,0.35
1771,2,7,7,10,24,0.2916666666666667
1772,1,10,5,13,28,0.3571428571428571
1773,2,3,1,4,8,0.375
1774,9,5,1,8,14,0.3571428571428571
1775,2,1,1,2,4,0.25
1776,5,5,5,12,22,0.2272727272727272
1777,4,2,0,4,6,0.3333333333333333
1778,1,4,6,6,16,0.25
1779,1,3,5,8,16,0.1875
1780,2,1,0,3,4,0.25
1781,6,4,4,7,15,0.2666666666666666
1782,1,4,3,6,13,0.3076923076923077
1783,1,2,3,6,11,0.1818181818181818
1784,3,5,4,8,17,0.2941176470588235
1785,1,1,0,3,4,0.25
1786,2,9,2,9,20,0.45
1787,1,5,7,9,21,0.238095238095238
1788,3,6,2,8,16,0.375
1789,1,1,0,2,3,0.3333333333333333
1790,3,5,3,5,13,0.3846153846153846
1791,2,2,0,3,5,0.4
1792,3,2,1,4,7,0.2857142857142857
1793,3,4,4,12,20,0.2
1794,2,9,5,9,23,0.391304347826087
1795,1,1,1,2,4,0.25
1796,2,5,2,6,13,0.3846153846153846
1797,1,4,6,5,15,0.2666666666666666
1798,1,3,11,9,23,0.1304347826086956
1799,3,4,1,2,7,0.5714285714285714
1800,2,4,0,3,7,0.5714285714285714
1801,3,4,1,4,9,0.4444444444444444
1802,8,6,4,13,23,0.2608695652173913
1803,3,4,1,4,9,0.4444444444444444
1804,4,2,1,5,8,0.25
1805,3,2,1,3,6,0.3333333333333333
1806,1,2,9,13,24,0.0833333333333333
1807,3,4,1,6,11,0.3636363636363636
1808,2,7,4,3,14,0.5
1809,11,8,5,9,22,0.3636363636363636
1810,3,4,0,4,8,0.5
1811,1,3,10,4,17,0.1764705882352941
1812,2,2,0,3,5,0.4
1813,1,4,4,6,14,0.2857142857142857
1814,5,6,2,6,14,0.4285714285714285
1815,1,6,10,6,22,0.2727272727272727
1816,1,2,0,3,5,0.4
1817,3,8,1,6,15,0.5333333333333333
1818,2,1,0,3,4,0.25
1819,1,5,10,12,27,0.1851851851851851
1820,1,1,0,2,3,0.3333333333333333
1821,1,4,6,10,20,0.2
1822,1,4,5,4,13,0.3076923076923077
1823,1,8,4,7,19,0.4210526315789473
1824,4,10,8,10,28,0.3571428571428571
1825,1,2,0,4,6,0.3333333333333333
1826,1,2,0,4,6,0.3333333333333333
1827,1,2,8,12,22,0.0909090909090909
1828,2,8,1,7,16,0.5
1829,1,5,3,5,13,0.3846153846153846
1830,1,1,0,2,3,0.3333333333333333
1831,1,4,2,8,14,0.2857142857142857
1832,1,5,4,4,13,0.3846153846153846
1833,1,6,6,7,19,0.3157894736842105
1834,11,8,3,7,18,0.4444444444444444
1835,3,2,1,3,6,0.3333333333333333
1836,1,1,0,3,4,0.25
1837,4,9,0,4,13,0.6923076923076923
1838,1,5,10,6,21,0.238095238095238
1839,2,2,0,3,5,0.4
1840,2,7,6,11,24,0.2916666666666667
1841,2,2,0,3,5,0.4
1842,6,6,2,11,19,0.3157894736842105
1843,1,1,0,3,4,0.25
1844,1,1,0,3,4,0.25
1845,3,9,1,8,18,0.5
1846,1,3,7,9,19,0.1578947368421052
1847,2,7,7,10,24,0.2916666666666667
1848,3,5,5,13,23,0.217391304347826
1849,1,5,8,4,17,0.2941176470588235
1850,2,1,1,2,4,0.25
1851,2,4,0,4,8,0.5
1852,1,5,6,11,22,0.2272727272727272
1853,1,1,1,3,5,0.2
1854,2,7,1,7,15,0.4666666666666667
1855,1,1,1,2,4,0.25
1856,1,5,5,5,15,0.3333333333333333
1857,4,9,5,7,21,0.4285714285714285
1858,2,6,3,4,13,0.4615384615384615
1859,1,4,10,5,19,0.2105263157894736
1860,1,4,7,8,19,0.2105263157894736
1861,2,2,0,3,5,0.4
1862,8,10,4,6,20,0.5
1863,1,2,3,5,10,0.2
1864,2,3,1,6,10,0.3
1865,1,1,1,2,4,0.25
1866,1,4,6,4,14,0.2857142857142857
1867,0,27,0,0,27,1.0
1868,2,3,5,8,16,0.1875
1869,2,2,0,3,5,0.4
1870,1,1,0,3,4,0.25
1871,1,4,4,6,14,0.2857142857142857
1872,3,3,0,3,6,0.5
1873,2,3,1,8,12,0.25
1874,1,3,4,6,13,0.2307692307692307
1875,4,6,11,7,24,0.25
1876,1,3,0,3,6,0.5
1877,1,1,0,3,4,0.25
1878,1,1,1,2,4,0.25
1879,2,7,8,5,20,0.35
1880,1,4,6,13,23,0.1739130434782608
1881,3,5,5,5,15,0.3333333333333333
1882,6,10,5,10,25,0.4
1883,7,4,4,8,16,0.25
1884,1,1,0,4,5,0.2
1885,2,3,0,3,6,0.5
1886,1,2,1,4,7,0.2857142857142857
1887,1,1,0,2,3,0.3333333333333333
1888,1,1,0,4,5,0.2
1889,2,6,2,12,20,0.3
1890,0,7,9,6,22,0.3181818181818182
1891,1,7,5,13,25,0.28
1892,3,11,5,11,27,0.4074074074074074
1893,1,1,0,3,4,0.25
1894,3,4,2,11,17,0.2352941176470588
1895,1,3,3,7,13,0.2307692307692307
1896,1,9,3,6,18,0.5
1897,5,9,3,7,19,0.4736842105263157
1898,1,2,0,4,6,0.3333333333333333
1899,2,4,2,7,13,0.3076923076923077
1900,3,3,0,3,6,0.5
1901,2,3,1,2,6,0.5
1902,2,6,6,9,21,0.2857142857142857
1903,2,1,0,3,4,0.25
1904,5,4,2,9,15,0.2666666666666666
1905,3,11,2,8,21,0.5238095238095238
1906,1,0,0,3,3,0.0
1907,1,1,0,4,5,0.2
1908,1,5,11,5,21,0.238095238095238
1909,1,1,0,3,4,0.25
1910,1,1,0,3,4,0.25
1911,1,4,6,12,22,0.1818181818181818
1912,2,2,2,3,7,0.2857142857142857
1913,2,3,4,10,17,0.1764705882352941
1914,2,3,8,7,18,0.1666666666666666
1915,1,4,7,10,21,0.1904761904761904
1916,3,3,0,3,6,0.5
1917,2,3,0,4,7,0.4285714285714285
1918,1,3,1,4,8,0.375
1919,2,3,3,10,16,0.1875
1920,1,4,4,10,18,0.2222222222222222
1921,1,10,4,8,22,0.4545454545454545
1922,1,4,2,9,15,0.2666666666666666
1923,1,1,0,3,4,0.25
1924,5,5,3,5,13,0.3846153846153846
1925,1,6,11,10,27,0.2222222222222222
1926,3,2,1,4,7,0.2857142857142857
1927,3,8,5,10,23,0.3478260869565217
1928,1,5,3,6,14,0.3571428571428571
1929,3,2,0,4,6,0.3333333333333333
1930,3,3,1,3,7,0.4285714285714285
1931,1,3,0,4,7,0.4285714285714285
1932,1,6,7,12,25,0.24
1933,2,8,2,10,20,0.4
1934,2,6,8,12,26,0.2307692307692307
1935,1,3,10,7,20,0.15
1936,1,3,6,11,20,0.15
1937,2,6,3,5,14,0.4285714285714285
1938,1,1,0,3,4,0.25
1939,5,5,2,5,12,0.4166666666666667
1940,2,6,3,5,14,0.4285714285714285
1941,3,3,1,5,9,0.3333333333333333
1942,0,25,0,0,25,1.0
1943,2,4,4,8,16,0.25
1944,4,3,0,4,7,0.4285714285714285
1945,1,2,1,2,5,0.4
1946,1,1,0,2,3,0.3333333333333333
1947,3,4,0,4,8,0.5
1948,3,3,0,3,6,0.5
1949,0,5,7,9,21,0.238095238095238
1950,1,2,1,4,7,0.2857142857142857
1951,8,6,3,5,14,0.4285714285714285
1952,1,0,0,3,3,0.0
1953,6,4,1,5,10,0.4
1954,1,3,5,3,11,0.2727272727272727
1955,3,3,0,4,7,0.4285714285714285
1956,2,3,3,8,14,0.2142857142857142
1957,1,5,5,8,18,0.2777777777777778
1958,2,3,1,4,8,0.375
1959,0,9,7,11,27,0.3333333333333333
1960,1,5,5,5,15,0.3333333333333333
1961,2,1,0,3,4,0.25
1962,0,7,6,8,21,0.3333333333333333
1963,1,6,5,4,15,0.4
1964,3,4,3,8,15,0.2666666666666666
1965,4,7,1,6,14,0.5
1966,1,4,1,6,11,0.3636363636363636
1967,1,1,0,3,4,0.25
1968,1,1,0,2,3,0.3333333333333333
1969,3,3,2,2,7,0.4285714285714285
1970,1,0,0,3,3,0.0
1971,3,2,0,4,6,0.3333333333333333
1972,2,2,0,3,5,0.4
1973,3,8,4,8,20,0.4
1974,4,5,5,3,13,0.3846153846153846
1975,1,3,1,7,11,0.2727272727272727
1976,3,8,2,10,20,0.4
1977,1,5,6,5,16,0.3125
1978,3,4,0,4,8,0.5
1979,1,7,7,9,23,0.3043478260869565
1980,6,11,2,8,21,0.5238095238095238
1981,1,2,9,13,24,0.0833333333333333
1982,1,0,0,3,3,0.0
1983,1,2,1,2,5,0.4
1984,3,2,0,3,5,0.4
1985,2,1,0,3,4,0.25
1986,1,0,0,3,3,0.0
1987,3,2,0,4,6,0.3333333333333333
1988,1,2,0,3,5,0.4
1989,6,4,2,5,11,0.3636363636363636
1990,2,8,3,6,17,0.4705882352941176
1991,2,8,5,13,26,0.3076923076923077
1992,2,2,0,4,6,0.3333333333333333
1993,1,0,0,3,3,0.0
1994,1,1,0,3,4,0.25
1995,4,10,5,7,22,0.4545454545454545
1996,4,2,1,3,6,0.3333333333333333
1997,2,11,8,4,23,0.4782608695652174
1998,3,7,2,11,20,0.35
1999,3,3,0,3,6,0.5
2000,4,11,6,8,25,0.44
2001,1,6,2,3,11,0.5454545454545454
2002,2,3,3,7,13,0.2307692307692307
2003,4,10,3,12,25,0.4
2004,4,4,4,10,18,0.2222222222222222
2005,1,2,0,3,5,0.4
2006,1,10,3,10,23,0.4347826086956521
2007,1,5,4,8,17,0.2941176470588235
2008,10,4,6,9,19,0.2105263157894736
2009,2,2,0,3,5,0.4
2010,1,2,0,3,5,0.4
2011,8,4,3,6,13,0.3076923076923077
2012,3,4,1,4,9,0.4444444444444444
2013,1,3,1,4,8,0.375
2014,1,7,8,12,27,0.2592592592592592
2015,2,2,5,5,12,0.1666666666666666
2016,1,5,6,10,21,0.238095238095238
2017,1,1,0,3,4,0.25
2018,6,7,2,6,15,0.4666666666666667
2019,2,6,3,4,13,0.4615384615384615
2020,2,3,0,3,6,0.5
2021,1,1,0,3,4,0.25
2022,1,3,0,3,6,0.5
2023,3,2,10,12,24,0.0833333333333333
2024,3,7,3,13,23,0.3043478260869565
2025,2,9,2,12,23,0.391304347826087
2026,3,3,1,3,7,0.4285714285714285
2027,1,4,4,8,16,0.25
2028,2,2,0,3,5,0.4
2029,5,9,6,12,27,0.3333333333333333
2030,2,4,5,4,13,0.3076923076923077
2031,1,2,1,3,6,0.3333333333333333
2032,2,4,7,4,15,0.2666666666666666
2033,2,3,0,4,7,0.4285714285714285
2034,1,1,0,3,4,0.25
2035,3,6,2,8,16,0.375
2036,1,6,3,10,19,0.3157894736842105
2037,1,1,1,2,4,0.25
2038,2,5,2,11,18,0.2777777777777778
2039,1,9,6,5,20,0.45
2040,2,5,5,7,17,0.2941176470588235
2041,1,1,1,2,4,0.25
2042,1,2,1,3,6,0.3333333333333333
2043,2,3,0,4,7,0.4285714285714285
2044,4,6,2,5,13,0.4615384615384615
2045,1,9,7,13,29,0.3103448275862069
2046,3,8,9,7,24,0.3333333333333333
2047,1,4,6,7,17,0.2352941176470588
2048,1,6,9,7,22,0.2727272727272727
2049,2,1,1,4,6,0.1666666666666666
2050,1,0,0,3,3,0.0
2051,7,5,1,8,14,0.3571428571428571
2052,1,1,0,2,3,0.3333333333333333
2053,1,4,1,7,12,0.3333333333333333
2054,1,4,10,7,21,0.1904761904761904
2055,4,10,5,7,22,0.4545454545454545
2056,1,1,0,3,4,0.25
2057,1,3,7,8,18,0.1666666666666666
2058,5,4,1,5,10,0.4
2059,2,4,4,10,18,0.2222222222222222
2060,1,2,3,4,9,0.2222222222222222
2061,1,1,0,3,4,0.25
2062,3,6,7,11,24,0.25
2063,2,1,0,3,4,0.25
2064,2,8,4,6,18,0.4444444444444444
2065,1,2,0,4,6,0.3333333333333333
2066,2,2,0,3,5,0.4
2067,1,2,1,4,7,0.2857142857142857
2068,2,7,2,8,17,0.4117647058823529
2069,3,5,1,4,10,0.5
2070,1,5,3,12,20,0.25
2071,6,8,2,7,17,0.4705882352941176
2072,1,7,3,13,23,0.3043478260869565
2073,2,1,0,3,4,0.25
2074,1,2,2,2,6,0.3333333333333333
2075,5,7,1,6,14,0.5
2076,2,6,8,10,24,0.25
2077,2,2,0,3,5,0.4
2078,2,6,8,11,25,0.24
2079,1,3,10,8,21,0.1428571428571428
2080,1,0,1,2,3,0.0
2081,2,3,0,4,7,0.4285714285714285
2082,1,1,0,2,3,0.3333333333333333
2083,3,3,0,4,7,0.4285714285714285
2084,4,5,2,12,19,0.2631578947368421
2085,2,1,0,4,5,0.2
2086,1,5,6,12,23,0.217391304347826
2087,2,7,1,8,16,0.4375
2088,1,4,3,10,17,0.2352941176470588
2089,4,8,4,7,19,0.4210526315789473
2090,1,1,0,2,3,0.3333333333333333
2091,1,1,0,3,4,0.25
2092,1,5,6,8,19,0.2631578947368421
2093,3,2,1,2,5,0.4
2094,3,3,5,6,14,0.2142857142857142
2095,1,8,2,4,14,0.5714285714285714
2096,5,3,4,3,10,0.3
2097,1,1,1,2,4,0.25
2098,1,2,2,5,9,0.2222222222222222
2099,4,3,2,2,7,0.4285714285714285
2100,1,1,0,3,4,0.25
2101,2,2,0,3,5,0.4
2102,5,2,1,4,7,0.2857142857142857
2103,1,2,0,4,6,0.3333333333333333
2104,7,9,4,8,21,0.4285714285714285
2105,1,11,3,4,18,0.6111111111111112
2106,1,2,0,2,4,0.5
2107,4,3,1,3,7,0.4285714285714285
2108,4,4,1,7,12,0.3333333333333333
2109,2,1,1,4,6,0.1666666666666666
2110,2,2,0,3,5,0.4
2111,2,5,3,6,14,0.3571428571428571
2112,4,3,1,3,7,0.4285714285714285
2113,5,3,4,3,10,0.3
2114,1,1,0,3,4,0.25
2115,2,2,0,4,6,0.3333333333333333
2116,5,3,1,4,8,0.375
2117,1,1,0,3,4,0.25
2118,2,7,4,9,20,0.35
2119,1,4,1,6,11,0.3636363636363636
2120,3,9,10,4,23,0.391304347826087
2121,1,6,2,4,12,0.5
2122,6,5,1,8,14,0.3571428571428571
2123,1,6,5,11,22,0.2727272727272727
2124,2,1,0,3,4,0.25
2125,2,2,1,3,6,0.3333333333333333
2126,3,5,4,8,17,0.2941176470588235
2127,0,4,3,7,14,0.2857142857142857
2128,1,4,8,5,17,0.2352941176470588
2129,1,1,0,3,4,0.25
2130,1,9,1,7,17,0.5294117647058824
2131,1,11,3,12,26,0.4230769230769231
2132,2,6,4,11,21,0.2857142857142857
2133,3,6,3,5,14,0.4285714285714285
2134,2,9,3,8,20,0.45
2135,1,5,6,7,18,0.2777777777777778
2136,1,4,2,10,16,0.25
2137,5,7,1,6,14,0.5
2138,2,7,3,3,13,0.5384615384615384
2139,2,3,1,6,10,0.3
2140,3,3,0,3,6,0.5
2141,4,8,2,7,17,0.4705882352941176
2142,1,1,1,4,6,0.1666666666666666
2143,3,2,1,3,6,0.3333333333333333
2144,1,1,0,3,4,0.25
2145,4,7,4,13,24,0.2916666666666667
2146,1,8,3,11,22,0.3636363636363636
2147,1,7,10,6,23,0.3043478260869565
2148,3,3,5,6,14,0.2142857142857142
2149,2,1,1,3,5,0.2
2150,1,7,5,12,24,0.2916666666666667
2151,1,1,1,2,4,0.25
2152,1,0,0,3,3,0.0
2153,1,7,7,10,24,0.2916666666666667
2154,2,9,5,6,20,0.45
2155,4,3,0,3,6,0.5
2156,1,3,0,4,7,0.4285714285714285
2157,2,6,6,3,15,0.4
2158,7,5,4,4,13,0.3846153846153846
2159,4,3,0,3,6,0.5
2160,2,2,2,2,6,0.3333333333333333
2161,4,8,8,6,22,0.3636363636363636
2162,5,7,1,6,14,0.5
2163,2,5,5,11,21,0.238095238095238
2164,1,1,0,4,5,0.2
2165,6,3,1,5,9,0.3333333333333333
2166,4,9,3,4,16,0.5625
2167,4,2,1,3,6,0.3333333333333333
2168,1,1,0,3,4,0.25
2169,2,1,1,2,4,0.25
2170,6,8,1,7,16,0.5
2171,1,6,2,9,17,0.3529411764705882
2172,2,2,0,3,5,0.4
2173,1,4,6,8,18,0.2222222222222222
2174,0,1,0,0,1,1.0
2175,1,1,0,2,3,0.3333333333333333
2176,2,2,0,3,5,0.4
2177,0,4,6,7,17,0.2352941176470588
2178,1,1,0,2,3,0.3333333333333333
2179,4,6,1,6,13,0.4615384615384615
2180,3,3,2,10,15,0.2
2181,1,3,6,11,20,0.15
2182,4,3,2,2,7,0.4285714285714285
2183,3,2,0,4,6,0.3333333333333333
2184,3,7,6,6,19,0.3684210526315789
2185,6,8,2,6,16,0.5
2186,8,11,1,6,18,0.6111111111111112
2187,5,4,2,8,14,0.2857142857142857
2188,2,2,1,2,5,0.4
2189,3,3,1,2,6,0.5
2190,2,9,4,12,25,0.36
2191,1,0,0,3,3,0.0
2192,1,1,0,2,3,0.3333333333333333
2193,2,9,3,4,16,0.5625
2194,7,8,2,5,15,0.5333333333333333
2195,1,2,3,13,18,0.1111111111111111
2196,2,6,5,10,21,0.2857142857142857
2197,3,3,1,4,8,0.375
